,PLAYER_ID,PLAYER_NAME,TEAM_ID,TEAM_ABBREVIATION,GP,W,L,MIN,OREB,OREB_CONTEST,OREB_UNCONTEST,OREB_CONTEST_PCT,OREB_CHANCES,OREB_CHANCE_PCT,OREB_CHANCE_DEFER,OREB_CHANCE_PCT_ADJ,AVG_OREB_DIST,DREB,DREB_CONTEST,DREB_UNCONTEST,DREB_CONTEST_PCT,DREB_CHANCES,DREB_CHANCE_PCT,DREB_CHANCE_DEFER,DREB_CHANCE_PCT_ADJ,AVG_DREB_DIST,REB,REB_CONTEST,REB_UNCONTEST,REB_CONTEST_PCT,REB_CHANCES,REB_CHANCE_PCT,REB_CHANCE_DEFER,REB_CHANCE_PCT_ADJ,AVG_REB_DIST,Season
0,201985,AJ Price,1610612739,CLE,26,11,15,324.0,6,1,5,0.167,20,0.3,0,0.3,15.1,26,8,18,0.308,48,0.542,4,0.591,11.7,32,9,23,0.281,68,0.471,4,0.5,12.3,2014-15
1,201166,Aaron Brooks,1610612741,CHI,82,50,32,1885.0,32,12,18,0.375,153,0.209,8,0.221,11.9,134,20,115,0.149,296,0.453,23,0.491,10.3,166,32,133,0.193,449,0.37,31,0.397,10.6,2014-15
2,203932,Aaron Gordon,1610612753,ORL,47,14,33,797.0,46,34,11,0.739,110,0.418,3,0.43,5.5,123,38,86,0.309,208,0.591,18,0.647,5.8,169,72,97,0.426,318,0.531,21,0.569,5.7,2014-15
3,203940,Adreian Payne,1610612750,MIN,32,7,25,740.0,48,26,25,0.542,117,0.41,5,0.429,8.0,114,37,75,0.325,188,0.606,16,0.663,4.5,162,63,100,0.389,305,0.531,21,0.57,5.6,2014-15
4,201143,Al Horford,1610612737,ATL,76,56,20,2318.0,131,80,50,0.611,265,0.494,10,0.514,7.3,413,189,222,0.458,707,0.584,54,0.632,5.7,544,269,272,0.494,972,0.56,64,0.599,6.1,2014-15
5,2744,Al Jefferson,1610612766,CHA,65,25,40,1992.0,99,59,39,0.596,237,0.418,9,0.434,8.6,449,163,282,0.363,701,0.641,51,0.691,4.1,548,222,321,0.405,938,0.584,60,0.624,4.9,2014-15
6,202329,Al-Farouq Aminu,1610612742,DAL,74,45,29,1366.0,114,74,38,0.649,248,0.46,18,0.496,6.7,228,83,141,0.364,389,0.586,47,0.667,5.6,342,157,179,0.459,637,0.537,65,0.598,6.0,2014-15
7,101187,Alan Anderson,1610612751,BKN,74,35,39,1744.0,31,15,15,0.484,124,0.25,7,0.265,10.4,173,40,129,0.231,311,0.556,35,0.627,8.2,204,55,144,0.27,435,0.469,42,0.519,8.6,2014-15
8,202692,Alec Burks,1610612762,UTA,27,9,18,899.0,19,10,9,0.526,83,0.229,4,0.241,9.4,95,19,75,0.2,163,0.583,17,0.651,6.8,114,29,84,0.254,246,0.463,21,0.507,7.2,2014-15
9,203945,Alex Kirk,1610612739,CLE,5,2,3,14.0,1,1,0,1.0,2,0.5,0,0.5,4.1,0,0,0,0.0,0,0.0,0,0.0,0.0,1,1,0,1.0,2,0.5,0,0.5,4.1,2014-15
10,203458,Alex Len,1610612756,PHX,69,35,34,1518.0,142,105,34,0.739,335,0.424,8,0.434,5.1,312,159,152,0.51,593,0.526,71,0.598,3.6,454,264,186,0.581,928,0.489,79,0.535,4.1,2014-15
11,203144,Alexey Shved,1610612752,NYK,42,10,32,767.0,23,12,12,0.522,86,0.267,4,0.28,11.6,76,17,59,0.224,136,0.559,12,0.613,8.4,99,29,71,0.293,222,0.446,16,0.481,9.3,2014-15
12,201582,Alexis Ajinca,1610612740,NOP,68,41,27,957.0,104,72,32,0.692,222,0.468,5,0.479,5.5,211,91,123,0.431,333,0.634,21,0.676,4.1,315,163,155,0.517,555,0.568,26,0.595,4.6,2014-15
13,203459,Allen Crabbe,1610612757,POR,51,36,15,683.0,7,2,4,0.286,35,0.2,0,0.2,14.3,66,12,54,0.182,126,0.524,9,0.564,5.9,73,14,58,0.192,161,0.453,9,0.48,6.6,2014-15
14,202087,Alonzo Gee,1610612757,POR,54,21,33,661.0,37,20,16,0.541,120,0.308,7,0.327,8.0,57,21,36,0.368,106,0.538,8,0.582,7.5,94,41,52,0.436,226,0.416,15,0.445,7.7,2014-15
15,2405,Amar'e Stoudemire,1610612742,DAL,58,19,39,1236.0,109,84,23,0.771,283,0.385,8,0.396,5.0,218,103,115,0.472,400,0.545,33,0.594,3.9,327,187,138,0.572,683,0.479,41,0.509,4.2,2014-15
16,101161,Amir Johnson,1610612761,TOR,75,44,31,1979.0,159,118,40,0.742,382,0.416,12,0.43,5.4,297,153,141,0.515,635,0.468,72,0.528,4.3,456,271,181,0.594,1017,0.448,84,0.489,4.7,2014-15
17,2760,Anderson Varejao,1610612739,CLE,26,16,10,636.0,57,30,24,0.526,143,0.399,3,0.407,6.1,113,45,68,0.398,220,0.514,19,0.562,4.7,170,75,92,0.441,363,0.468,22,0.499,5.2,2014-15
18,203958,Andre Dawkins,1610612748,MIA,4,2,2,22.0,0,0,0,0.0,0,0.0,0,0.0,0.0,2,2,0,1.0,4,0.5,1,0.667,9.6,2,2,0,1.0,4,0.5,1,0.667,9.6,2014-15
19,203083,Andre Drummond,1610612765,DET,82,32,50,2502.0,437,321,103,0.735,785,0.557,12,0.565,4.8,667,273,393,0.409,995,0.67,66,0.718,3.9,1104,594,496,0.538,1780,0.62,78,0.649,4.3,2014-15
20,2738,Andre Iguodala,1610612744,GSW,77,64,13,2069.0,44,14,30,0.318,149,0.295,3,0.301,13.0,213,47,175,0.221,363,0.587,16,0.614,9.1,257,61,205,0.237,512,0.502,19,0.521,9.8,2014-15
21,1889,Andre Miller,1610612758,SAC,81,44,37,1253.0,37,24,12,0.649,141,0.262,9,0.28,8.2,116,17,99,0.147,198,0.586,13,0.627,10.8,153,41,111,0.268,339,0.451,22,0.483,10.2,2014-15
22,203460,Andre Roberson,1610612760,OKC,67,41,26,1286.0,60,30,27,0.5,206,0.291,4,0.297,8.2,195,59,136,0.303,325,0.6,28,0.657,5.9,255,89,163,0.349,531,0.48,32,0.511,6.4,2014-15
23,200745,Andrea Bargnani,1610612752,NYK,29,5,24,785.0,32,17,15,0.531,88,0.364,5,0.386,8.0,95,27,66,0.284,170,0.559,12,0.601,5.5,127,44,81,0.346,258,0.492,17,0.527,6.1,2014-15
24,1905,Andrei Kirilenko,1610612751,BKN,7,3,4,36.0,2,1,1,0.5,6,0.333,0,0.333,15.2,6,3,3,0.5,11,0.545,3,0.75,3.1,8,4,4,0.5,17,0.471,3,0.571,6.1,2014-15
25,101106,Andrew Bogut,1610612744,GSW,67,58,9,1583.0,141,105,34,0.745,270,0.522,3,0.528,5.0,402,193,202,0.48,705,0.57,58,0.621,3.9,543,298,236,0.549,975,0.557,61,0.594,4.2,2014-15
26,203094,Andrew Nicholson,1610612753,ORL,40,14,26,492.0,17,10,6,0.588,45,0.378,0,0.378,7.3,65,32,33,0.492,135,0.481,16,0.546,4.3,82,42,39,0.512,180,0.456,16,0.5,4.9,2014-15
27,203952,Andrew Wiggins,1610612750,MIN,81,16,65,2937.0,134,91,40,0.679,430,0.312,13,0.321,6.4,239,81,158,0.339,454,0.526,30,0.564,8.1,373,172,198,0.461,884,0.422,43,0.444,7.5,2014-15
28,203461,Anthony Bennett,1610612750,MIN,56,12,44,885.0,51,33,17,0.647,127,0.402,4,0.415,6.4,161,57,103,0.354,257,0.626,16,0.668,4.6,212,90,120,0.425,384,0.552,20,0.582,5.0,2014-15
29,203076,Anthony Davis,1610612740,NOP,68,39,29,2455.0,173,120,51,0.694,360,0.481,12,0.497,5.8,523,222,298,0.424,730,0.716,35,0.753,4.8,696,342,349,0.491,1090,0.639,47,0.667,5.1,2014-15
30,201627,Anthony Morrow,1610612760,OKC,74,42,32,1806.0,40,17,23,0.425,108,0.37,2,0.377,12.8,155,46,107,0.297,236,0.657,20,0.718,9.0,195,63,130,0.323,344,0.567,22,0.606,9.8,2014-15
31,201229,Anthony Tolliver,1610612765,DET,76,36,40,1433.0,51,18,30,0.353,134,0.381,4,0.392,8.5,185,59,128,0.319,402,0.46,42,0.514,5.0,236,77,158,0.326,536,0.44,46,0.482,5.7,2014-15
32,203462,Archie Goodwin,1610612756,PHX,41,16,25,535.0,27,19,6,0.704,90,0.3,3,0.31,6.6,47,13,36,0.277,91,0.516,7,0.56,6.5,74,32,42,0.432,181,0.409,10,0.433,6.6,2014-15
33,202620,Arinze Onuaku,1610612750,MIN,6,0,6,68.0,7,6,1,0.857,15,0.467,0,0.467,3.5,14,5,9,0.357,18,0.778,0,0.778,4.9,21,11,10,0.524,33,0.636,0,0.636,4.4,2014-15
34,203382,Aron Baynes,1610612759,SAS,70,49,21,1122.0,109,77,29,0.706,309,0.353,7,0.361,4.9,209,95,113,0.455,372,0.562,40,0.63,4.4,318,172,142,0.541,681,0.467,47,0.502,4.6,2014-15
35,201167,Arron Afflalo,1610612757,POR,78,35,43,2502.0,27,12,16,0.444,117,0.231,4,0.239,16.2,220,20,200,0.091,359,0.613,26,0.661,9.6,247,32,216,0.13,476,0.519,30,0.554,10.4,2014-15
36,201948,Austin Daye,1610612737,ATL,34,17,17,344.0,10,4,6,0.4,24,0.417,0,0.417,14.9,65,25,39,0.385,104,0.625,10,0.691,6.2,75,29,45,0.387,128,0.586,10,0.636,7.4,2014-15
37,203085,Austin Rivers,1610612746,LAC,76,46,30,1563.0,27,11,16,0.407,124,0.218,6,0.229,11.6,125,21,106,0.168,276,0.453,32,0.512,8.5,152,32,122,0.211,400,0.38,38,0.42,9.0,2014-15
38,202340,Avery Bradley,1610612738,BOS,77,37,40,2428.0,46,13,37,0.283,188,0.245,9,0.257,14.0,195,27,172,0.138,386,0.505,42,0.567,6.1,241,40,209,0.166,574,0.42,51,0.461,7.8,2014-15
39,2732,Ben Gordon,1610612753,ORL,56,17,39,790.0,6,1,6,0.167,39,0.154,1,0.158,14.0,57,11,47,0.193,107,0.533,13,0.606,9.1,63,12,53,0.19,146,0.432,14,0.477,9.7,2014-15
40,203463,Ben McLemore,1610612758,SAC,82,29,53,2670.0,31,5,24,0.161,156,0.199,7,0.208,15.1,210,36,174,0.171,450,0.467,45,0.519,7.9,241,41,198,0.17,606,0.398,52,0.435,8.7,2014-15
41,2757,Beno Udrih,1610612763,MEM,79,55,24,1494.0,20,7,13,0.35,78,0.256,3,0.267,15.2,123,15,110,0.122,255,0.482,25,0.535,10.2,143,22,123,0.154,333,0.429,28,0.469,10.9,2014-15
42,203108,Bernard James,1610612742,DAL,16,6,10,158.0,18,12,6,0.667,43,0.419,2,0.439,5.4,21,9,12,0.429,42,0.5,4,0.553,5.6,39,21,18,0.538,85,0.459,6,0.494,5.5,2014-15
43,202687,Bismack Biyombo,1610612766,CHA,64,26,38,1243.0,159,126,32,0.792,388,0.41,16,0.427,5.0,248,92,153,0.371,459,0.54,41,0.593,4.5,407,218,185,0.536,847,0.481,57,0.515,4.7,2014-15
44,201933,Blake Griffin,1610612746,LAC,67,47,20,2356.0,126,83,36,0.659,315,0.4,20,0.427,7.2,382,143,237,0.374,680,0.562,47,0.603,5.0,508,226,273,0.445,995,0.511,67,0.547,5.5,2014-15
45,202711,Bojan Bogdanovic,1610612751,BKN,78,36,42,1854.0,50,36,14,0.72,181,0.276,5,0.284,7.5,163,26,137,0.16,266,0.613,14,0.647,8.5,213,62,151,0.291,447,0.477,19,0.498,8.2,2014-15
46,2564,Boris Diaw,1610612759,SAS,81,55,26,1984.0,78,50,26,0.641,226,0.345,14,0.368,7.2,270,91,177,0.337,514,0.525,49,0.581,5.8,348,141,203,0.405,740,0.47,63,0.514,6.1,2014-15
47,203078,Bradley Beal,1610612764,WAS,63,37,26,2107.0,57,28,28,0.491,191,0.298,8,0.311,10.8,184,40,141,0.217,307,0.599,25,0.652,6.7,241,68,169,0.282,498,0.484,33,0.518,7.7,2014-15
48,201148,Brandan Wright,1610612756,PHX,75,37,38,1449.0,128,67,58,0.523,248,0.516,8,0.533,7.6,193,91,99,0.472,402,0.48,42,0.536,5.2,321,158,157,0.492,650,0.494,50,0.535,6.2,2014-15
49,101138,Brandon Bass,1610612738,BOS,82,40,42,1929.0,139,81,56,0.583,309,0.45,14,0.471,7.1,259,82,175,0.317,448,0.578,39,0.633,6.5,398,163,231,0.41,757,0.526,53,0.565,6.7,2014-15
50,203561,Brandon Davies,1610612755,PHI,27,6,21,423.0,38,21,12,0.553,77,0.494,1,0.5,7.0,45,15,30,0.333,100,0.45,10,0.5,5.3,83,36,42,0.434,177,0.469,11,0.5,6.0,2014-15
51,201943,Brandon Jennings,1610612765,DET,41,17,24,1173.0,21,8,15,0.381,96,0.219,4,0.228,13.3,83,10,73,0.12,164,0.506,14,0.553,10.1,104,18,88,0.173,260,0.4,18,0.43,11.0,2014-15
52,202688,Brandon Knight,1610612756,PHX,62,32,30,2000.0,27,14,12,0.519,129,0.209,8,0.223,12.3,212,30,182,0.142,406,0.522,32,0.567,8.1,239,44,194,0.184,535,0.447,40,0.483,8.6,2014-15
53,201575,Brandon Rush,1610612744,GSW,33,27,6,271.0,4,2,2,0.5,14,0.286,0,0.286,12.2,37,10,27,0.27,65,0.569,6,0.627,5.4,41,12,29,0.293,79,0.519,6,0.562,6.1,2014-15
54,2217,Brendan Haywood,1610612739,CLE,22,14,8,119.0,6,3,3,0.5,20,0.3,0,0.3,6.5,23,6,16,0.261,39,0.59,7,0.719,4.8,29,9,19,0.31,59,0.492,7,0.558,5.2,2014-15
55,203148,Brian Roberts,1610612766,CHA,72,30,42,1330.0,13,2,11,0.154,56,0.232,6,0.26,18.9,96,3,96,0.031,197,0.487,20,0.542,10.1,109,5,107,0.046,253,0.431,26,0.48,11.1,2014-15
56,201572,Brook Lopez,1610612751,BKN,72,34,38,2100.0,214,157,43,0.734,396,0.54,5,0.547,5.5,321,154,162,0.48,576,0.557,50,0.61,5.4,535,311,205,0.581,972,0.55,55,0.583,5.4,2014-15
57,203998,Bruno Caboclo,1610612761,TOR,8,7,1,23.0,1,1,0,1.0,4,0.25,1,0.333,2.3,1,0,1,0.0,2,0.5,0,0.5,22.0,2,1,1,0.5,6,0.333,1,0.4,12.1,2014-15
58,203955,Bryce Cotton,1610612762,UTA,15,9,6,159.0,3,1,2,0.333,6,0.5,0,0.5,22.1,15,1,14,0.067,24,0.625,0,0.625,9.6,18,2,16,0.111,30,0.6,0,0.6,11.7,2014-15
59,201228,C.J. Watson,1610612754,IND,57,25,32,1422.0,18,3,16,0.167,75,0.24,3,0.25,14.7,145,17,127,0.117,276,0.525,22,0.571,8.5,163,20,143,0.123,351,0.464,25,0.5,9.2,2014-15
60,203912,C.J. Wilcox,1610612746,LAC,21,15,6,101.0,1,1,0,1.0,4,0.25,0,0.25,16.8,6,1,5,0.167,15,0.4,0,0.4,6.0,7,2,5,0.286,19,0.368,0,0.368,7.6,2014-15
61,203468,CJ McCollum,1610612757,POR,62,37,25,973.0,14,5,9,0.357,58,0.241,4,0.259,10.6,77,14,63,0.182,159,0.484,13,0.527,8.7,91,19,72,0.209,217,0.419,17,0.455,9.0,2014-15
62,101139,CJ Miles,1610612754,IND,70,31,39,1841.0,18,3,12,0.167,101,0.178,1,0.18,15.2,196,44,150,0.224,337,0.582,30,0.638,7.5,214,47,162,0.22,438,0.489,31,0.526,8.1,2014-15
63,203946,Cameron Bairstow,1610612741,CHI,18,12,6,64.0,6,6,0,1.0,18,0.333,0,0.333,5.8,2,0,2,0.0,17,0.118,1,0.125,3.3,8,6,2,0.75,35,0.229,1,0.235,5.1,2014-15
64,201171,Carl Landry,1610612758,SAC,70,26,44,1192.0,99,65,32,0.657,246,0.402,8,0.416,6.4,169,56,112,0.331,292,0.579,29,0.643,6.1,268,121,144,0.451,538,0.498,37,0.535,6.3,2014-15
65,2430,Carlos Boozer,1610612747,LAL,71,18,53,1692.0,111,76,34,0.685,311,0.357,10,0.369,6.1,371,137,227,0.369,572,0.649,39,0.696,4.7,482,213,261,0.442,883,0.546,49,0.578,5.0,2014-15
66,2546,Carmelo Anthony,1610612752,NYK,39,10,29,1400.0,72,49,22,0.681,161,0.447,5,0.462,7.1,189,49,140,0.259,293,0.645,21,0.695,5.9,261,98,162,0.375,454,0.575,26,0.61,6.2,2014-15
67,2406,Caron Butler,1610612765,DET,78,30,48,1623.0,21,11,10,0.524,127,0.165,2,0.168,10.6,175,46,126,0.263,345,0.507,36,0.566,6.4,196,57,136,0.291,472,0.415,38,0.452,6.9,2014-15
68,201858,Cartier Martin,1610612765,DET,23,7,16,198.0,0,0,0,0.0,12,0.0,0,0.0,0.0,20,6,12,0.3,32,0.625,5,0.741,6.2,20,6,12,0.3,44,0.455,5,0.513,6.2,2014-15
69,202718,Chandler Parsons,1610612742,DAL,66,41,25,2186.0,64,35,28,0.547,235,0.272,12,0.287,9.9,259,65,195,0.251,459,0.564,27,0.6,7.3,323,100,223,0.31,694,0.465,39,0.493,7.8,2014-15
70,101112,Channing Frye,1610612753,ORL,75,23,52,1870.0,27,15,10,0.556,58,0.466,1,0.474,9.9,266,110,156,0.414,467,0.57,35,0.616,4.6,293,125,166,0.427,525,0.558,36,0.599,5.0,2014-15
71,101111,Charlie Villanueva,1610612742,DAL,64,37,27,678.0,30,16,11,0.533,69,0.435,2,0.448,7.2,119,40,79,0.336,188,0.633,10,0.669,4.7,149,56,90,0.376,257,0.58,12,0.608,5.2,2014-15
72,201978,Chase Budinger,1610612750,MIN,66,8,58,1282.0,33,18,16,0.545,108,0.306,3,0.314,8.9,164,42,122,0.256,276,0.594,19,0.638,7.3,197,60,138,0.305,384,0.513,22,0.544,7.7,2014-15
73,2365,Chris Andersen,1610612748,MIA,59,26,33,1102.0,74,52,19,0.703,213,0.347,5,0.356,5.2,217,100,115,0.461,410,0.529,44,0.593,3.8,291,152,134,0.522,623,0.467,49,0.507,4.2,2014-15
74,2547,Chris Bosh,1610612748,MIA,44,19,25,1556.0,46,27,15,0.587,127,0.362,5,0.377,9.8,264,95,167,0.36,449,0.588,35,0.638,5.1,310,122,182,0.394,576,0.538,40,0.578,5.8,2014-15
75,203142,Chris Copeland,1610612754,IND,50,19,31,828.0,23,17,7,0.739,89,0.258,2,0.264,7.6,88,19,68,0.216,149,0.591,16,0.662,5.6,111,36,75,0.324,238,0.466,18,0.505,6.1,2014-15
76,201604,Chris Douglas-Roberts,1610612746,LAC,12,5,7,103.0,1,0,1,0.0,7,0.143,0,0.143,20.9,11,4,7,0.364,13,0.846,0,0.846,6.6,12,4,8,0.333,20,0.6,0,0.6,7.8,2014-15
77,203187,Chris Johnson,1610612762,UTA,29,9,20,527.0,8,3,5,0.375,35,0.229,1,0.235,5.5,47,14,33,0.298,98,0.48,11,0.54,8.0,55,17,38,0.309,133,0.414,12,0.455,7.6,2014-15
78,2549,Chris Kaman,1610612757,POR,74,47,27,1398.0,149,105,41,0.705,334,0.446,6,0.454,5.8,335,162,170,0.484,565,0.593,36,0.633,4.0,484,267,211,0.552,899,0.538,42,0.565,4.5,2014-15
79,101108,Chris Paul,1610612746,LAC,82,56,26,2857.0,52,21,29,0.404,206,0.252,6,0.26,15.7,324,60,267,0.185,589,0.55,41,0.591,9.6,376,81,296,0.215,795,0.473,47,0.503,10.5,2014-15
80,101236,Chuck Hayes,1610612761,TOR,29,17,12,255.0,18,11,7,0.611,52,0.346,3,0.367,5.2,33,19,14,0.576,77,0.429,9,0.485,4.1,51,30,21,0.588,129,0.395,12,0.436,4.5,2014-15
81,203921,Cleanthony Early,1610612752,NYK,39,6,33,647.0,22,13,8,0.591,70,0.314,4,0.333,12.3,75,25,52,0.333,153,0.49,22,0.573,5.8,97,38,60,0.392,223,0.435,26,0.492,7.2,2014-15
82,203991,Clint Capela,1610612745,HOU,12,8,4,90.0,10,7,2,0.7,23,0.435,1,0.455,6.1,26,17,9,0.654,41,0.634,5,0.722,5.5,36,24,11,0.667,64,0.563,6,0.621,5.7,2014-15
83,203469,Cody Zeller,1610612766,CHA,62,27,35,1487.0,97,55,37,0.567,287,0.338,8,0.348,6.5,265,93,172,0.351,487,0.544,43,0.597,5.2,362,148,209,0.409,774,0.468,51,0.501,5.5,2014-15
84,202332,Cole Aldrich,1610612752,NYK,60,11,49,962.0,100,64,33,0.64,233,0.429,4,0.437,6.2,234,95,140,0.406,377,0.621,28,0.67,3.5,334,159,173,0.476,610,0.548,32,0.578,4.3,2014-15
85,201147,Corey Brewer,1610612745,HOU,79,42,37,2063.0,80,41,37,0.513,238,0.336,11,0.352,9.5,213,52,162,0.244,392,0.543,29,0.587,8.8,293,93,199,0.317,630,0.465,40,0.497,9.0,2014-15
86,203928,Cory Jefferson,1610612751,BKN,50,18,32,531.0,47,34,13,0.723,108,0.435,2,0.443,6.5,98,26,71,0.265,174,0.563,10,0.598,4.7,145,60,84,0.414,282,0.514,12,0.537,5.2,2014-15
87,202709,Cory Joseph,1610612759,SAS,79,53,26,1444.0,44,23,20,0.523,157,0.28,7,0.293,11.7,148,36,113,0.243,268,0.552,23,0.604,8.3,192,59,133,0.307,425,0.452,30,0.486,9.1,2014-15
88,201584,Courtney Lee,1610612763,MEM,77,51,26,2354.0,21,6,15,0.286,93,0.226,3,0.233,12.6,157,25,134,0.159,296,0.53,16,0.561,10.0,178,31,149,0.174,389,0.458,19,0.481,10.3,2014-15
89,201571,D.J. Augustin,1610612760,OKC,82,37,45,1964.0,20,7,13,0.35,120,0.167,5,0.174,20.0,141,13,132,0.092,249,0.566,15,0.603,12.0,161,20,145,0.124,369,0.436,20,0.461,13.0,2014-15
90,2563,Dahntay Jones,1610612746,LAC,33,23,10,123.0,1,0,1,0.0,7,0.143,0,0.143,1.4,10,5,5,0.5,13,0.769,1,0.833,5.8,11,5,6,0.455,20,0.55,1,0.579,5.4,2014-15
91,203081,Damian Lillard,1610612757,POR,82,51,31,2925.0,49,15,36,0.306,232,0.211,11,0.222,14.6,329,49,282,0.149,612,0.538,50,0.585,7.4,378,64,318,0.169,844,0.448,61,0.483,8.3,2014-15
92,204014,Damjan Rudez,1610612754,IND,68,28,40,1047.0,8,2,6,0.25,41,0.195,0,0.195,13.7,39,11,29,0.282,86,0.453,6,0.488,11.1,47,13,35,0.277,127,0.37,6,0.388,11.5,2014-15
93,201568,Danilo Gallinari,1610612743,DEN,59,23,36,1426.0,31,16,15,0.516,128,0.242,6,0.254,9.9,187,35,152,0.187,334,0.56,25,0.605,6.5,218,51,167,0.234,462,0.472,31,0.506,7.0,2014-15
94,101122,Danny Granger,1610612756,PHX,29,10,19,590.0,20,15,5,0.75,62,0.323,2,0.333,12.0,53,18,37,0.34,124,0.427,17,0.495,7.9,73,33,42,0.452,186,0.392,19,0.437,8.9,2014-15
95,201980,Danny Green,1610612759,SAS,81,55,26,2312.0,54,21,30,0.389,160,0.338,13,0.367,13.3,289,90,198,0.311,561,0.515,42,0.557,5.7,343,111,228,0.324,721,0.476,55,0.515,6.8,2014-15
96,201967,Dante Cunningham,1610612740,NOP,66,37,29,1652.0,70,34,35,0.486,214,0.327,11,0.345,9.3,186,52,133,0.28,344,0.541,23,0.579,6.6,256,86,168,0.336,558,0.459,34,0.489,7.4,2014-15
97,203957,Dante Exum,1610612762,UTA,82,38,44,1817.0,27,5,21,0.185,82,0.329,2,0.338,16.7,104,14,88,0.135,231,0.45,15,0.481,11.0,131,19,109,0.145,313,0.419,17,0.443,12.2,2014-15
98,203121,Darius Miller,1610612740,NOP,5,1,4,43.0,0,0,0,0.0,1,0.0,0,0.0,0.0,1,1,0,1.0,5,0.2,0,0.2,3.6,1,1,0,1.0,6,0.167,0,0.167,3.6,2014-15
99,202721,Darius Morris,1610612751,BKN,38,14,24,299.0,7,4,3,0.571,26,0.269,0,0.269,15.0,20,3,18,0.15,40,0.5,3,0.541,11.6,27,7,21,0.259,66,0.409,3,0.429,12.5,2014-15
100,201589,Darrell Arthur,1610612743,DEN,58,22,36,988.0,53,31,22,0.585,111,0.477,0,0.477,7.8,118,50,68,0.424,275,0.429,31,0.484,5.3,171,81,90,0.474,386,0.443,31,0.482,6.1,2014-15
101,201954,Darren Collison,1610612758,SAC,45,16,29,1565.0,19,4,15,0.211,99,0.192,5,0.202,17.3,124,14,110,0.113,244,0.508,22,0.559,10.5,143,18,125,0.126,343,0.417,27,0.453,11.4,2014-15
102,101135,David Lee,1610612744,GSW,49,37,12,904.0,81,51,28,0.63,195,0.415,5,0.426,6.7,176,75,98,0.426,281,0.626,18,0.669,4.4,257,126,126,0.49,476,0.54,23,0.567,5.1,2014-15
103,204065,David Stockton,1610612758,SAC,3,1,2,33.0,0,0,0,0.0,3,0.0,0,0.0,0.0,2,0,2,0.0,7,0.286,0,0.286,11.4,2,0,2,0.0,10,0.2,0,0.2,11.4,2014-15
104,204033,David Wear,1610612758,SAC,2,0,2,7.0,2,1,1,0.5,4,0.5,0,0.5,9.8,0,0,0,0.0,1,0.0,0,0.0,0.0,2,1,1,0.5,5,0.4,0,0.4,9.8,2014-15
105,2561,David West,1610612754,IND,66,32,34,1895.0,108,73,31,0.676,234,0.462,8,0.478,7.4,341,102,238,0.299,557,0.612,36,0.655,5.4,449,175,269,0.39,791,0.568,44,0.601,5.8,2014-15
106,201599,DeAndre Jordan,1610612746,LAC,82,56,26,2820.0,397,281,105,0.708,744,0.534,12,0.542,5.3,829,270,551,0.326,1163,0.713,77,0.763,4.6,1226,551,656,0.449,1907,0.643,89,0.674,4.8,2014-15
107,201971,DeJuan Blair,1610612764,WAS,29,15,14,180.0,16,14,2,0.875,52,0.308,1,0.314,4.3,40,16,24,0.4,65,0.615,9,0.714,4.1,56,30,26,0.536,117,0.479,10,0.523,4.1,2014-15
108,201942,DeMar DeRozan,1610612761,TOR,60,37,23,2100.0,41,15,26,0.366,158,0.259,4,0.266,14.8,236,56,177,0.237,372,0.634,29,0.688,7.2,277,71,203,0.256,530,0.523,33,0.557,8.3,2014-15
109,202326,DeMarcus Cousins,1610612758,SAC,59,23,36,2013.0,185,138,34,0.746,449,0.412,8,0.42,5.2,562,231,333,0.411,837,0.671,46,0.71,4.2,747,369,367,0.494,1286,0.581,54,0.606,4.4,2014-15
110,201960,DeMarre Carroll,1610612737,ATL,70,53,17,2189.0,99,56,43,0.566,264,0.375,11,0.391,9.3,273,49,223,0.179,441,0.619,43,0.686,6.9,372,105,266,0.282,705,0.528,54,0.571,7.6,2014-15
111,203471,Dennis Schroder,1610612737,ATL,77,57,20,1516.0,29,12,17,0.414,135,0.215,6,0.225,14.2,135,15,121,0.111,275,0.491,24,0.538,8.1,164,27,138,0.165,410,0.4,30,0.432,9.2,2014-15
112,101114,Deron Williams,1610612751,BKN,68,34,34,2114.0,29,12,18,0.414,132,0.22,5,0.228,13.9,208,24,183,0.115,400,0.52,31,0.564,9.0,237,36,201,0.152,532,0.445,36,0.478,9.6,2014-15
113,202324,Derrick Favors,1610612762,UTA,74,33,41,2280.0,196,159,34,0.811,433,0.453,14,0.468,5.6,411,200,213,0.487,719,0.572,55,0.619,4.8,607,359,247,0.591,1152,0.527,69,0.56,5.1,2014-15
114,201565,Derrick Rose,1610612741,CHI,51,33,18,1530.0,35,20,14,0.571,163,0.215,11,0.23,10.0,126,14,112,0.111,259,0.486,14,0.514,10.1,161,34,126,0.211,422,0.382,25,0.406,10.0,2014-15
115,202682,Derrick Williams,1610612758,SAC,74,27,47,1462.0,41,23,17,0.561,122,0.336,6,0.353,8.0,161,35,126,0.217,249,0.647,20,0.703,6.9,202,58,143,0.287,371,0.544,26,0.586,7.1,2014-15
116,2734,Devin Harris,1610612742,DAL,76,45,31,1685.0,13,5,7,0.385,80,0.163,7,0.178,17.0,122,24,98,0.197,261,0.467,20,0.506,9.3,135,29,105,0.215,341,0.396,27,0.43,10.0,2014-15
117,203906,Devyn Marble,1610612753,ORL,16,3,13,208.0,5,0,4,0.0,15,0.333,1,0.357,17.3,26,3,23,0.115,37,0.703,0,0.703,8.2,31,3,27,0.097,52,0.596,1,0.608,9.4,2014-15
118,203473,Dewayne Dedmon,1610612753,ORL,59,17,42,845.0,118,83,27,0.703,200,0.59,3,0.599,5.1,177,77,97,0.435,286,0.619,37,0.711,4.3,295,160,124,0.542,486,0.607,40,0.661,4.6,2014-15
119,203079,Dion Waiters,1610612760,OKC,79,46,33,2180.0,40,13,28,0.325,161,0.248,5,0.256,15.1,146,23,124,0.158,272,0.537,19,0.577,10.5,186,36,152,0.194,433,0.43,24,0.455,11.5,2014-15
120,1717,Dirk Nowitzki,1610612742,DAL,77,47,30,2282.0,44,25,19,0.568,156,0.282,5,0.291,8.3,413,174,236,0.421,674,0.613,54,0.666,4.3,457,199,255,0.435,830,0.551,59,0.593,4.7,2014-15
121,202388,Donald Sloan,1610612754,IND,53,22,31,1107.0,12,1,11,0.083,56,0.214,4,0.231,16.9,131,16,115,0.122,222,0.59,17,0.639,8.6,143,17,126,0.119,278,0.514,21,0.556,9.3,2014-15
122,202700,Donatas Motiejunas,1610612745,HOU,70,47,23,2006.0,133,87,43,0.654,368,0.361,13,0.375,7.7,281,118,165,0.42,632,0.445,49,0.482,4.6,414,205,208,0.495,1000,0.414,62,0.441,5.6,2014-15
123,2748,Dorell Wright,1610612757,POR,48,28,20,592.0,14,9,5,0.643,40,0.35,1,0.359,8.5,97,23,73,0.237,150,0.647,16,0.724,6.2,111,32,78,0.288,190,0.584,17,0.642,6.5,2014-15
124,203926,Doug McDermott,1610612741,CHI,36,23,13,321.0,6,3,2,0.5,27,0.222,3,0.25,7.5,37,7,30,0.189,58,0.638,5,0.698,6.5,43,10,32,0.233,85,0.506,8,0.558,6.6,2014-15
125,203110,Draymond Green,1610612744,GSW,79,64,15,2490.0,114,83,25,0.728,235,0.485,9,0.504,6.8,533,221,302,0.415,854,0.624,53,0.665,4.4,647,304,327,0.47,1089,0.594,62,0.63,4.8,2014-15
126,2400,Drew Gooden,1610612764,WAS,51,31,20,864.0,72,49,21,0.681,165,0.436,3,0.444,5.5,151,46,106,0.305,243,0.621,13,0.657,4.7,223,95,127,0.426,408,0.547,16,0.569,5.0,2014-15
127,204079,Drew Gordon,1610612755,PHI,9,0,9,71.0,7,4,3,0.571,16,0.438,1,0.467,6.0,11,5,6,0.455,24,0.458,2,0.5,4.2,18,9,9,0.5,40,0.45,3,0.486,4.9,2014-15
128,202779,Dwight Buycks,1610612747,LAL,6,1,5,123.0,2,1,1,0.5,11,0.182,1,0.2,16.5,10,2,8,0.2,18,0.556,0,0.556,9.1,12,3,9,0.25,29,0.414,1,0.429,10.3,2014-15
129,2730,Dwight Howard,1610612745,HOU,40,28,12,1189.0,108,79,30,0.731,261,0.414,10,0.43,4.5,313,136,177,0.435,476,0.658,37,0.713,3.5,421,215,207,0.511,737,0.571,47,0.61,3.8,2014-15
130,203939,Dwight Powell,1610612742,DAL,29,11,18,236.0,18,10,7,0.556,49,0.367,1,0.375,6.9,32,7,25,0.219,51,0.627,3,0.667,5.6,50,17,32,0.34,100,0.5,4,0.521,6.0,2014-15
131,2548,Dwyane Wade,1610612748,MIA,61,27,34,1934.0,57,36,20,0.632,181,0.315,9,0.331,9.0,157,40,119,0.255,307,0.511,20,0.547,8.1,214,76,139,0.355,488,0.439,29,0.466,8.4,2014-15
132,202734,E'Twaun Moore,1610612741,CHI,56,36,20,504.0,12,5,7,0.417,52,0.231,0,0.231,11.1,34,9,25,0.265,71,0.479,6,0.523,10.2,46,14,32,0.304,123,0.374,6,0.393,10.5,2014-15
133,2853,Earl Barron,1610612756,PHX,16,5,11,143.0,14,10,5,0.714,41,0.341,3,0.368,3.8,14,5,9,0.357,32,0.438,5,0.519,5.4,28,15,14,0.536,73,0.384,8,0.431,4.6,2014-15
134,201947,Earl Clark,1610612751,BKN,10,6,4,93.0,1,1,0,1.0,5,0.2,0,0.2,3.8,22,6,16,0.273,36,0.611,4,0.688,3.5,23,7,16,0.304,41,0.561,4,0.622,3.5,2014-15
135,202334,Ed Davis,1610612747,LAL,79,20,59,1840.0,230,163,63,0.709,500,0.46,12,0.471,4.8,370,122,247,0.33,617,0.6,62,0.667,4.9,600,285,310,0.475,1117,0.537,74,0.575,4.8,2014-15
136,202327,Ekpe Udoh,1610612746,LAC,33,24,9,128.0,7,4,3,0.571,18,0.389,0,0.389,10.8,19,11,8,0.579,40,0.475,5,0.543,5.4,26,15,11,0.577,58,0.448,5,0.491,6.8,2014-15
137,203901,Elfrid Payton,1610612753,ORL,82,25,57,2489.0,107,50,55,0.467,372,0.288,19,0.303,8.6,242,41,199,0.169,431,0.561,35,0.611,8.1,349,91,254,0.261,803,0.435,54,0.466,8.3,2014-15
138,202407,Elijah Millsap,1610612762,UTA,47,25,22,924.0,28,15,11,0.536,73,0.384,7,0.424,7.7,122,27,95,0.221,240,0.508,26,0.57,7.9,150,42,106,0.28,313,0.479,33,0.536,7.9,2014-15
139,202343,Elliot Williams,1610612755,PHI,13,6,7,119.0,0,0,0,0.0,8,0.0,0,0.0,0.0,8,0,8,0.0,17,0.471,3,0.571,7.6,8,0,8,0.0,25,0.32,3,0.364,7.6,2014-15
140,1882,Elton Brand,1610612737,ATL,36,25,11,486.0,28,18,7,0.643,68,0.412,4,0.438,5.1,72,35,39,0.486,146,0.493,17,0.558,5.3,100,53,46,0.53,214,0.467,21,0.518,5.2,2014-15
141,202683,Enes Kanter,1610612760,OKC,75,32,43,2136.0,277,219,47,0.791,662,0.418,15,0.428,4.0,394,146,242,0.371,669,0.589,61,0.648,4.6,671,365,289,0.544,1331,0.504,76,0.535,4.4,2014-15
142,202339,Eric Bledsoe,1610612756,PHX,81,39,42,2800.0,72,38,37,0.528,253,0.285,13,0.3,11.1,351,66,287,0.188,664,0.529,51,0.573,7.5,423,104,324,0.246,917,0.461,64,0.496,8.2,2014-15
143,201569,Eric Gordon,1610612740,NOP,61,35,26,2018.0,28,12,17,0.429,102,0.275,4,0.286,15.7,131,17,114,0.13,242,0.541,19,0.587,8.9,159,29,131,0.182,344,0.462,23,0.495,10.2,2014-15
144,203961,Eric Moreland,1610612758,SAC,3,0,3,2.0,0,0,0,0.0,0,0.0,0,0.0,0.0,1,1,1,1.0,0,0.0,0,0.0,3.9,1,1,1,1.0,0,0.0,0,0.0,3.9,2014-15
145,203475,Erick Green,1610612743,DEN,43,15,28,410.0,7,3,4,0.429,18,0.389,0,0.389,13.0,24,3,23,0.125,44,0.545,3,0.585,9.3,31,6,27,0.194,62,0.5,3,0.525,10.1,2014-15
146,101141,Ersan Ilyasova,1610612749,MIL,57,25,32,1307.0,80,63,14,0.788,204,0.392,6,0.404,4.6,195,86,108,0.441,347,0.562,28,0.611,5.3,275,149,122,0.542,551,0.499,34,0.532,5.1,2014-15
147,203095,Evan Fournier,1610612753,ORL,58,19,39,1661.0,28,9,19,0.321,131,0.214,12,0.235,12.8,125,29,96,0.232,236,0.53,18,0.573,10.1,153,38,115,0.248,367,0.417,30,0.454,10.6,2014-15
148,202323,Evan Turner,1610612738,BOS,82,40,42,2260.0,40,22,17,0.55,186,0.215,7,0.223,9.6,377,84,289,0.223,601,0.627,45,0.678,5.3,417,106,306,0.254,787,0.53,52,0.567,5.8,2014-15
149,203105,Festus Ezeli,1610612744,GSW,46,39,7,504.0,60,45,14,0.75,151,0.397,5,0.411,4.0,95,44,48,0.463,187,0.508,15,0.552,3.9,155,89,62,0.574,338,0.459,20,0.487,3.9,2014-15
150,101128,Francisco Garcia,1610612745,HOU,14,10,4,200.0,3,3,0,1.0,16,0.188,0,0.188,11.8,14,2,12,0.143,30,0.467,3,0.519,7.9,17,5,12,0.294,46,0.37,3,0.395,8.6,2014-15
151,203128,Furkan Aldemir,1610612755,PHI,41,9,32,540.0,78,57,19,0.731,179,0.436,6,0.451,5.0,98,36,58,0.367,162,0.605,16,0.671,4.4,176,93,77,0.528,341,0.516,22,0.552,4.6,2014-15
152,203539,Gal Mekel,1610612742,DAL,4,2,2,43.0,0,0,0,0.0,4,0.0,0,0.0,0.0,1,0,1,0.0,3,0.333,0,0.333,8.4,1,0,1,0.0,7,0.143,0,0.143,8.4,2014-15
153,202066,Garrett Temple,1610612764,WAS,52,28,24,736.0,24,7,16,0.292,52,0.462,2,0.48,17.9,66,13,53,0.197,134,0.493,12,0.541,8.3,90,20,69,0.222,186,0.484,14,0.523,10.9,2014-15
154,203914,Gary Harris,1610612743,DEN,55,18,37,719.0,21,10,12,0.476,70,0.3,5,0.323,14.3,43,9,33,0.209,84,0.512,4,0.538,7.4,64,19,45,0.297,154,0.416,9,0.441,9.8,2014-15
155,202390,Gary Neal,1610612750,MIN,54,24,30,1192.0,14,5,8,0.357,74,0.189,3,0.197,15.1,115,16,99,0.139,206,0.558,18,0.612,8.4,129,21,107,0.163,280,0.461,21,0.498,9.1,2014-15
156,201588,George Hill,1610612754,IND,43,26,17,1267.0,25,8,16,0.32,91,0.275,7,0.298,11.5,154,26,128,0.169,258,0.597,22,0.653,7.7,179,34,144,0.19,349,0.513,29,0.559,8.2,2014-15
157,101123,Gerald Green,1610612756,PHX,74,34,40,1446.0,33,11,21,0.333,106,0.311,8,0.337,13.2,153,33,117,0.216,271,0.565,18,0.605,7.9,186,44,138,0.237,377,0.493,26,0.53,8.9,2014-15
158,201945,Gerald Henderson,1610612766,CHA,80,32,48,2315.0,36,9,28,0.25,148,0.243,2,0.247,17.4,237,35,203,0.148,401,0.591,28,0.635,7.9,273,44,231,0.161,549,0.497,30,0.526,9.3,2014-15
159,2222,Gerald Wallace,1610612738,BOS,32,15,17,286.0,17,13,4,0.765,47,0.362,0,0.362,5.4,40,4,36,0.1,69,0.58,9,0.667,6.9,57,17,40,0.298,116,0.491,9,0.533,6.4,2014-15
160,203507,Giannis Antetokounmpo,1610612749,MIL,80,40,40,2508.0,99,65,35,0.657,301,0.329,10,0.34,8.0,438,137,300,0.313,694,0.631,59,0.69,5.8,537,202,335,0.376,995,0.54,69,0.58,6.2,2014-15
161,203540,Gigi Datome,1610612738,BOS,21,11,10,209.0,3,3,0,1.0,21,0.143,1,0.15,5.7,26,7,19,0.269,50,0.52,4,0.565,6.3,29,10,19,0.345,71,0.408,5,0.439,6.2,2014-15
162,201175,Glen Davis,1610612746,LAC,74,52,22,904.0,43,31,12,0.721,157,0.274,3,0.279,5.7,126,72,53,0.571,260,0.485,27,0.541,5.3,169,103,65,0.609,417,0.405,30,0.437,5.4,2014-15
163,203318,Glen Rice,1610612764,WAS,5,4,1,43.0,2,1,1,0.5,5,0.4,0,0.4,17.8,2,1,1,0.5,4,0.5,0,0.5,2.4,4,2,2,0.5,9,0.444,0,0.444,10.1,2014-15
164,203922,Glenn Robinson III,1610612755,PHI,35,2,33,261.0,15,11,4,0.733,39,0.385,0,0.385,8.6,24,4,20,0.167,46,0.522,5,0.585,6.4,39,15,24,0.385,85,0.459,5,0.488,7.3,2014-15
165,201609,Goran Dragic,1610612748,MIA,78,41,37,2640.0,81,38,42,0.469,256,0.316,8,0.327,12.2,193,34,157,0.176,420,0.46,30,0.495,10.8,274,72,199,0.263,676,0.405,38,0.429,11.2,2014-15
166,202330,Gordon Hayward,1610612762,UTA,76,35,41,2618.0,54,23,30,0.426,198,0.273,8,0.284,12.8,319,50,269,0.157,480,0.665,32,0.712,8.3,373,73,299,0.196,678,0.55,40,0.585,8.9,2014-15
167,203476,Gorgui Dieng,1610612750,MIN,72,16,56,2179.0,222,142,79,0.64,477,0.465,12,0.477,6.2,384,147,233,0.383,677,0.567,54,0.616,4.4,606,289,312,0.477,1154,0.525,66,0.557,5.1,2014-15
168,203511,Grant Jerrett,1610612762,UTA,8,6,2,51.0,2,0,2,0.0,6,0.333,0,0.333,15.3,7,1,6,0.143,8,0.875,2,1.167,5.7,9,1,8,0.111,14,0.643,2,0.75,7.8,2014-15
169,202328,Greg Monroe,1610612765,DET,69,25,44,2137.0,229,169,58,0.738,509,0.45,12,0.461,5.6,475,176,292,0.371,709,0.67,51,0.722,4.7,704,345,350,0.49,1218,0.578,63,0.61,5.0,2014-15
170,202962,Greg Smith,1610612742,DAL,42,27,15,363.0,26,17,9,0.654,68,0.382,1,0.388,6.1,53,19,34,0.358,110,0.482,14,0.552,4.1,79,36,43,0.456,178,0.444,15,0.485,4.7,2014-15
171,201880,Greg Stiemsma,1610612761,TOR,17,13,4,66.0,9,3,6,0.333,14,0.643,0,0.643,7.2,6,3,3,0.5,10,0.6,0,0.6,3.5,15,6,9,0.4,24,0.625,0,0.625,5.7,2014-15
172,202349,Greivis Vasquez,1610612761,TOR,82,49,33,1991.0,22,5,17,0.227,135,0.163,4,0.168,17.9,194,24,169,0.124,377,0.515,23,0.548,8.6,216,29,186,0.134,512,0.422,27,0.445,9.6,2014-15
173,203084,Harrison Barnes,1610612744,GSW,82,67,15,2318.0,117,58,60,0.496,306,0.382,9,0.394,9.8,336,90,245,0.268,616,0.545,56,0.6,6.1,453,148,305,0.327,922,0.491,65,0.529,7.1,2014-15
174,202355,Hassan Whiteside,1610612748,MIA,47,17,30,1134.0,144,124,17,0.861,341,0.422,2,0.425,4.1,335,153,177,0.457,528,0.634,40,0.686,3.7,479,277,194,0.578,869,0.551,42,0.579,3.8,2014-15
175,2045,Hedo Turkoglu,1610612746,LAC,62,42,20,705.0,5,1,4,0.2,34,0.147,2,0.156,13.3,94,24,70,0.255,150,0.627,11,0.676,5.5,99,25,74,0.253,184,0.538,13,0.579,5.9,2014-15
176,203156,Henry Sims,1610612755,PHI,73,14,59,1399.0,121,89,32,0.736,339,0.357,11,0.369,6.0,238,104,136,0.437,446,0.534,40,0.586,4.5,359,193,168,0.538,785,0.457,51,0.489,5.0,2014-15
177,201611,Henry Walker,1610612748,MIA,24,12,12,628.0,7,2,5,0.286,28,0.25,2,0.269,13.3,75,28,48,0.373,159,0.472,21,0.543,6.5,82,30,53,0.366,187,0.439,23,0.5,7.1,2014-15
178,203138,Hollis Thompson,1610612755,PHI,71,13,58,1776.0,53,24,26,0.453,129,0.411,6,0.431,12.0,145,43,103,0.297,267,0.543,22,0.592,8.3,198,67,129,0.338,396,0.5,28,0.538,9.3,2014-15
179,203546,Ian Clark,1610612743,DEN,30,9,21,192.0,4,1,3,0.25,11,0.364,0,0.364,15.6,12,2,10,0.167,27,0.444,2,0.48,12.3,16,3,13,0.188,38,0.421,2,0.444,13.1,2014-15
180,101133,Ian Mahinmi,1610612754,IND,61,28,33,1146.0,105,82,23,0.781,234,0.449,7,0.463,5.1,251,101,148,0.402,387,0.649,28,0.699,4.9,356,183,171,0.514,621,0.573,35,0.608,5.0,2014-15
181,202697,Iman Shumpert,1610612739,CLE,62,34,28,1545.0,55,19,34,0.345,128,0.43,4,0.444,13.2,169,33,138,0.195,268,0.631,16,0.671,7.3,224,52,172,0.232,396,0.566,20,0.596,8.7,2014-15
182,203477,Isaiah Canaan,1610612755,PHI,46,23,23,912.0,18,1,16,0.056,59,0.305,3,0.321,18.9,67,9,59,0.134,124,0.54,8,0.578,9.2,85,10,75,0.118,183,0.464,11,0.494,11.1,2014-15
183,202738,Isaiah Thomas,1610612738,BOS,67,40,27,1726.0,33,14,20,0.424,139,0.237,7,0.25,12.8,120,21,101,0.175,230,0.522,9,0.543,11.8,153,35,121,0.229,369,0.415,16,0.433,12.1,2014-15
184,202397,Ish Smith,1610612755,PHI,55,24,31,831.0,15,3,12,0.2,72,0.208,5,0.224,8.4,85,13,73,0.153,185,0.459,13,0.494,8.5,100,16,85,0.16,257,0.389,18,0.418,8.5,2014-15
185,200826,J.J. Barea,1610612742,DAL,77,49,28,1362.0,23,11,12,0.478,115,0.2,8,0.215,10.4,111,10,101,0.09,227,0.489,20,0.536,10.1,134,21,113,0.157,342,0.392,28,0.427,10.2,2014-15
186,201581,JJ Hickson,1610612743,DEN,73,26,47,1411.0,150,96,44,0.64,340,0.441,6,0.449,5.5,302,92,207,0.305,449,0.673,32,0.724,5.0,452,188,251,0.416,789,0.573,38,0.602,5.2,2014-15
187,200755,JJ Redick,1610612746,LAC,78,55,23,2409.0,22,1,19,0.045,101,0.218,4,0.227,19.0,145,18,126,0.124,307,0.472,38,0.539,10.4,167,19,145,0.114,408,0.409,42,0.456,11.4,2014-15
188,2747,JR Smith,1610612739,CLE,70,38,32,2079.0,30,9,20,0.3,113,0.265,12,0.297,14.9,188,37,150,0.197,300,0.627,21,0.674,9.2,218,46,170,0.211,413,0.528,33,0.574,10.0,2014-15
189,203960,JaKarr Sampson,1610612755,PHI,74,17,57,1131.0,35,12,21,0.343,101,0.347,4,0.361,11.7,128,24,102,0.188,245,0.522,18,0.564,6.3,163,36,123,0.221,346,0.471,22,0.503,7.4,2014-15
190,203210,JaMychal Green,1610612763,MEM,24,10,14,164.0,19,9,10,0.474,34,0.559,0,0.559,6.6,26,11,15,0.423,37,0.703,3,0.765,4.9,45,20,25,0.444,71,0.634,3,0.662,5.6,2014-15
191,201580,JaVale McGee,1610612743,DEN,23,8,15,256.0,18,11,6,0.611,45,0.4,1,0.409,7.1,43,15,27,0.349,86,0.5,10,0.566,3.8,61,26,33,0.426,131,0.466,11,0.508,4.8,2014-15
192,203913,Jabari Brown,1610612747,LAL,19,4,15,568.0,3,1,2,0.333,36,0.083,2,0.088,15.0,33,3,30,0.091,71,0.465,8,0.524,9.1,36,4,32,0.111,107,0.336,10,0.371,9.6,2014-15
193,203953,Jabari Parker,1610612749,MIL,25,13,12,738.0,50,20,26,0.4,99,0.505,3,0.521,9.4,88,33,50,0.375,176,0.5,13,0.54,5.6,138,53,76,0.384,275,0.502,16,0.533,7.0,2014-15
194,204022,Jack Cooley,1610612762,UTA,16,10,6,87.0,10,8,2,0.8,24,0.417,3,0.476,4.4,15,8,7,0.533,25,0.6,3,0.682,4.2,25,16,9,0.64,49,0.51,6,0.581,4.3,2014-15
195,203109,Jae Crowder,1610612738,BOS,82,47,35,1647.0,72,34,36,0.472,190,0.379,10,0.4,8.8,221,68,150,0.308,360,0.614,31,0.672,6.4,293,102,186,0.348,550,0.533,41,0.576,7.0,2014-15
196,203479,Jamaal Franklin,1610612743,DEN,3,1,2,13.0,1,1,0,1.0,2,0.5,0,0.5,9.0,1,0,1,0.0,1,1.0,0,1.0,12.0,2,1,1,0.5,3,0.667,0,0.667,10.5,2014-15
197,2037,Jamal Crawford,1610612746,LAC,64,44,20,1703.0,18,8,7,0.444,68,0.265,4,0.281,9.8,106,17,92,0.16,177,0.599,4,0.613,10.9,124,25,99,0.202,245,0.506,8,0.523,10.8,2014-15
198,2749,Jameer Nelson,1610612743,DEN,63,25,38,1406.0,33,10,22,0.303,87,0.379,4,0.398,12.5,113,21,91,0.186,240,0.471,20,0.514,8.6,146,31,113,0.212,327,0.446,24,0.482,9.5,2014-15
199,203516,James Ennis III,1610612748,MIA,62,27,35,1051.0,51,27,21,0.529,141,0.362,6,0.378,7.2,125,37,89,0.296,219,0.571,28,0.654,6.3,176,64,110,0.364,360,0.489,34,0.54,6.5,2014-15
200,201935,James Harden,1610612745,HOU,80,55,25,2941.0,74,39,35,0.527,295,0.251,14,0.263,9.5,381,84,296,0.22,631,0.604,49,0.655,7.7,455,123,331,0.27,926,0.491,63,0.527,8.0,2014-15
201,201949,James Johnson,1610612761,TOR,70,40,30,1370.0,61,37,25,0.607,174,0.351,5,0.361,8.6,196,53,146,0.27,322,0.609,23,0.656,5.2,257,90,171,0.35,496,0.518,28,0.549,6.0,2014-15
202,2592,James Jones,1610612739,CLE,56,35,21,665.0,9,2,7,0.222,29,0.31,1,0.321,19.3,52,16,36,0.308,106,0.491,10,0.542,6.2,61,18,43,0.295,135,0.452,11,0.492,8.2,2014-15
203,203949,James Michael McAdoo,1610612744,GSW,15,11,4,137.0,15,9,6,0.6,29,0.517,1,0.536,8.0,22,9,13,0.409,45,0.489,4,0.537,4.7,37,18,19,0.486,74,0.5,5,0.536,6.0,2014-15
204,203923,James Young,1610612738,BOS,31,14,17,332.0,9,2,6,0.222,24,0.375,2,0.409,16.6,33,9,22,0.273,54,0.611,6,0.688,6.2,42,11,28,0.262,78,0.538,8,0.6,8.4,2014-15
205,2457,Jannero Pargo,1610612766,CHA,9,2,7,73.0,0,0,0,0.0,5,0.0,0,0.0,0.0,3,1,3,0.333,8,0.375,0,0.375,5.0,3,1,3,0.333,13,0.231,0,0.231,5.0,2014-15
206,203099,Jared Cunningham,1610612746,LAC,19,12,7,89.0,1,1,0,1.0,5,0.2,0,0.2,7.0,8,3,5,0.375,16,0.5,3,0.615,7.6,9,4,5,0.444,21,0.429,3,0.5,7.5,2014-15
207,201162,Jared Dudley,1610612749,MIL,71,38,33,1694.0,43,24,18,0.558,128,0.336,5,0.35,8.9,172,54,119,0.314,410,0.42,40,0.465,6.8,215,78,137,0.363,538,0.4,45,0.436,7.2,2014-15
208,203096,Jared Sullinger,1610612738,BOS,58,26,32,1566.0,147,109,34,0.741,345,0.426,8,0.436,5.1,294,123,172,0.418,498,0.59,42,0.645,4.6,441,232,206,0.526,843,0.523,50,0.556,4.7,2014-15
209,203950,Jarnell Stokes,1610612763,MEM,19,12,7,126.0,16,12,3,0.75,44,0.364,3,0.39,3.6,18,3,15,0.167,38,0.474,2,0.5,4.4,34,15,18,0.441,82,0.415,5,0.442,4.1,2014-15
210,101127,Jarrett Jack,1610612751,BKN,80,36,44,2241.0,19,5,15,0.263,99,0.192,4,0.2,17.8,226,20,207,0.088,391,0.578,25,0.617,9.9,245,25,222,0.102,490,0.5,29,0.531,10.5,2014-15
211,101131,Jason Maxiell,1610612766,CHA,61,22,39,878.0,86,58,24,0.674,198,0.434,7,0.45,5.7,117,39,76,0.333,257,0.455,29,0.513,5.2,203,97,100,0.478,455,0.446,36,0.484,5.4,2014-15
212,2202,Jason Richardson,1610612755,PHI,19,4,15,416.0,13,9,4,0.692,35,0.371,3,0.406,4.8,53,9,44,0.17,87,0.609,6,0.654,8.2,66,18,48,0.273,122,0.541,9,0.584,7.6,2014-15
213,201160,Jason Smith,1610612752,NYK,81,17,64,1770.0,97,59,34,0.608,247,0.393,4,0.399,7.5,223,71,147,0.318,414,0.539,34,0.587,5.3,320,130,181,0.406,661,0.484,38,0.514,6.0,2014-15
214,1891,Jason Terry,1610612745,HOU,76,52,24,1618.0,15,3,13,0.2,69,0.217,3,0.227,18.9,103,10,93,0.097,215,0.479,18,0.523,11.9,118,13,106,0.11,284,0.415,21,0.449,12.8,2014-15
215,201574,Jason Thompson,1610612758,SAC,81,29,52,1991.0,139,103,33,0.741,335,0.415,10,0.428,5.8,391,152,236,0.389,651,0.601,53,0.654,4.6,530,255,269,0.481,986,0.538,63,0.574,5.0,2014-15
216,202399,Jeff Adrien,1610612745,HOU,17,1,16,215.0,23,15,7,0.652,55,0.418,0,0.418,4.8,54,19,34,0.352,76,0.711,8,0.794,3.8,77,34,41,0.442,131,0.588,8,0.626,4.1,2014-15
217,201965,Jeff Ayres,1610612759,SAS,51,33,18,383.0,37,27,10,0.73,82,0.451,3,0.468,5.5,80,28,51,0.35,131,0.611,8,0.65,4.0,117,55,61,0.47,213,0.549,11,0.579,4.5,2014-15
218,201145,Jeff Green,1610612763,MEM,78,41,37,2455.0,64,36,28,0.563,207,0.309,2,0.312,10.1,264,71,192,0.269,437,0.604,28,0.645,7.5,328,107,220,0.326,644,0.509,30,0.534,8.0,2014-15
219,201952,Jeff Teague,1610612737,ATL,73,53,20,2228.0,30,6,27,0.2,170,0.176,9,0.186,15.7,154,21,133,0.136,311,0.495,16,0.522,10.0,184,27,160,0.147,481,0.383,25,0.404,11.1,2014-15
220,203481,Jeff Withey,1610612740,NOP,37,17,20,259.0,23,15,7,0.652,51,0.451,3,0.479,6.1,41,21,19,0.512,74,0.554,3,0.577,3.6,64,36,26,0.563,125,0.512,6,0.538,4.5,2014-15
221,203106,Jeffery Taylor,1610612766,CHA,29,11,18,430.0,14,7,7,0.5,46,0.304,0,0.304,12.2,39,8,31,0.205,73,0.534,5,0.574,8.1,53,15,38,0.283,119,0.445,5,0.465,9.2,2014-15
222,203924,Jerami Grant,1610612755,PHI,65,18,47,1377.0,49,31,18,0.633,148,0.331,8,0.35,10.5,149,42,108,0.282,314,0.475,33,0.53,6.8,198,73,126,0.369,462,0.429,41,0.47,7.7,2014-15
223,202077,Jerel McNeal,1610612756,PHX,6,1,5,36.0,0,0,0,0.0,1,0.0,0,0.0,0.0,3,1,2,0.333,8,0.375,1,0.429,8.0,3,1,2,0.333,9,0.333,1,0.375,8.0,2014-15
224,202379,Jeremy Evans,1610612762,UTA,38,19,19,266.0,26,17,8,0.654,64,0.406,4,0.433,5.6,45,23,23,0.511,86,0.523,9,0.584,6.6,71,40,31,0.563,150,0.473,13,0.518,6.2,2014-15
225,203087,Jeremy Lamb,1610612760,OKC,47,27,20,633.0,8,2,6,0.25,36,0.222,2,0.235,6.6,99,20,78,0.202,142,0.697,7,0.733,6.7,107,22,84,0.206,178,0.601,9,0.633,6.7,2014-15
226,202391,Jeremy Lin,1610612747,LAL,74,19,55,1907.0,26,7,18,0.269,155,0.168,4,0.172,15.6,170,46,129,0.271,385,0.442,42,0.496,9.2,196,53,147,0.27,540,0.363,46,0.397,10.0,2014-15
227,202366,Jerome Jordan,1610612751,BKN,44,17,27,383.0,52,36,16,0.692,99,0.525,0,0.525,5.5,53,25,29,0.472,109,0.486,16,0.57,7.9,105,61,45,0.581,208,0.505,16,0.547,6.7,2014-15
228,203968,Jerrelle Benimon,1610612743,DEN,2,2,0,3.0,1,1,0,1.0,1,1.0,0,1.0,1.9,2,1,1,0.5,2,1.0,0,1.0,4.4,3,2,1,0.667,3,1.0,0,1.0,3.5,2014-15
229,201573,Jerryd Bayless,1610612749,MIL,76,38,38,1700.0,22,5,14,0.227,105,0.21,5,0.22,14.2,189,32,155,0.169,338,0.559,29,0.612,8.2,211,37,169,0.175,443,0.476,34,0.516,8.8,2014-15
230,202690,Jimmer Fredette,1610612740,NOP,50,27,23,509.0,8,1,7,0.125,28,0.286,1,0.296,15.1,32,5,28,0.156,69,0.464,6,0.508,10.8,40,6,35,0.15,97,0.412,7,0.444,11.6,2014-15
231,202710,Jimmy Butler,1610612741,CHI,65,40,25,2513.0,114,66,46,0.579,322,0.354,7,0.362,8.1,265,71,191,0.268,480,0.552,44,0.608,8.4,379,137,237,0.361,802,0.473,51,0.505,8.3,2014-15
232,201149,Joakim Noah,1610612741,CHI,67,39,28,2049.0,219,174,36,0.795,523,0.419,11,0.428,4.5,427,169,259,0.396,775,0.551,62,0.599,4.3,646,343,295,0.531,1298,0.498,73,0.527,4.4,2014-15
233,201975,Jodie Meeks,1610612765,DET,60,29,31,1462.0,12,2,10,0.167,71,0.169,4,0.179,19.0,92,12,81,0.13,154,0.597,11,0.643,9.7,104,14,91,0.135,225,0.462,15,0.495,10.8,2014-15
234,203925,Joe Harris,1610612739,CLE,51,32,19,493.0,7,2,5,0.286,24,0.292,1,0.304,17.6,34,5,29,0.147,72,0.472,6,0.515,8.9,41,7,34,0.171,96,0.427,7,0.461,10.4,2014-15
235,204060,Joe Ingles,1610612762,UTA,79,36,43,1673.0,22,6,16,0.273,76,0.289,0,0.289,20.6,153,29,127,0.19,252,0.607,12,0.638,9.5,175,35,143,0.2,328,0.534,12,0.554,10.9,2014-15
236,2207,Joe Johnson,1610612751,BKN,80,38,42,2791.0,53,30,22,0.566,203,0.261,6,0.269,10.6,331,67,262,0.202,451,0.734,34,0.794,7.6,384,97,284,0.253,654,0.587,40,0.625,8.0,2014-15
237,201202,Joel Anthony,1610612765,DET,49,25,24,406.0,32,22,10,0.688,93,0.344,2,0.352,6.1,61,19,42,0.311,129,0.473,15,0.535,4.5,93,41,52,0.441,222,0.419,17,0.454,5.1,2014-15
238,200777,Joel Freeland,1610612757,POR,48,34,14,617.0,62,45,16,0.726,144,0.431,2,0.437,5.8,129,50,77,0.388,241,0.535,28,0.606,4.1,191,95,93,0.497,385,0.496,30,0.538,4.7,2014-15
239,201595,Joey Dorsey,1610612745,HOU,68,47,21,851.0,102,79,22,0.775,269,0.379,10,0.394,5.2,174,76,99,0.437,285,0.611,24,0.667,4.3,276,155,121,0.562,554,0.498,34,0.531,4.6,2014-15
240,203530,Joffrey Lauvergne,1610612743,DEN,24,9,15,268.0,27,20,3,0.741,73,0.37,1,0.375,3.6,50,20,30,0.4,80,0.625,9,0.704,3.1,77,40,33,0.519,153,0.503,10,0.538,3.3,2014-15
241,203089,John Henson,1610612749,MIL,66,34,32,1211.0,123,92,30,0.748,227,0.542,6,0.557,5.4,186,89,97,0.478,355,0.524,30,0.572,3.8,309,181,127,0.586,582,0.531,36,0.566,4.4,2014-15
242,203098,John Jenkins,1610612737,ATL,24,13,11,297.0,2,0,2,0.0,14,0.143,0,0.143,25.8,37,4,32,0.108,73,0.507,3,0.529,8.6,39,4,34,0.103,87,0.448,3,0.464,9.5,2014-15
243,101249,John Lucas III,1610612765,DET,21,8,13,272.0,4,1,3,0.25,10,0.4,0,0.4,13.0,12,1,11,0.083,33,0.364,1,0.375,12.1,16,2,14,0.125,43,0.372,1,0.381,12.3,2014-15
244,2422,John Salmons,1610612740,NOP,21,9,12,270.0,4,0,4,0.0,18,0.222,1,0.235,27.0,17,3,14,0.176,33,0.515,3,0.567,9.6,21,3,18,0.143,51,0.412,4,0.447,12.9,2014-15
245,202322,John Wall,1610612764,WAS,79,45,34,2837.0,36,9,29,0.25,208,0.173,12,0.184,14.2,330,30,299,0.091,538,0.613,34,0.655,9.2,366,39,328,0.107,746,0.491,46,0.523,9.8,2014-15
246,203948,Johnny O'Bryant III,1610612749,MIL,33,16,17,357.0,25,13,11,0.52,65,0.385,4,0.41,7.1,38,14,24,0.368,90,0.422,8,0.463,5.7,63,27,35,0.429,155,0.406,12,0.441,6.2,2014-15
247,202720,Jon Leuer,1610612763,MEM,63,45,18,824.0,50,31,17,0.62,138,0.362,4,0.373,6.4,157,62,95,0.395,280,0.561,22,0.609,4.1,207,93,112,0.449,418,0.495,26,0.528,4.7,2014-15
248,201973,Jonas Jerebko,1610612738,BOS,75,37,38,1230.0,93,60,34,0.645,221,0.421,7,0.435,6.8,189,68,119,0.36,325,0.582,31,0.643,5.2,282,128,153,0.454,546,0.516,38,0.555,5.7,2014-15
249,202685,Jonas Valanciunas,1610612761,TOR,80,47,33,2096.0,215,171,36,0.795,544,0.395,6,0.4,3.9,478,197,281,0.412,797,0.6,64,0.652,3.7,693,368,317,0.531,1341,0.517,70,0.545,3.8,2014-15
250,203919,Jordan Adams,1610612763,MEM,30,14,16,248.0,9,5,4,0.556,26,0.346,2,0.375,9.2,19,6,13,0.316,31,0.613,3,0.679,7.0,28,11,17,0.393,57,0.491,5,0.538,7.7,2014-15
251,203903,Jordan Clarkson,1610612747,LAL,59,11,48,1476.0,56,33,23,0.589,181,0.309,11,0.329,9.4,135,19,117,0.141,275,0.491,30,0.551,8.0,191,52,140,0.272,456,0.419,41,0.46,8.4,2014-15
252,200770,Jordan Farmar,1610612746,LAC,36,23,13,529.0,8,1,7,0.125,39,0.205,2,0.216,18.0,34,8,25,0.235,84,0.405,7,0.442,8.9,42,9,32,0.214,123,0.341,9,0.368,10.7,2014-15
253,202706,Jordan Hamilton,1610612746,LAC,14,10,4,122.0,2,2,0,1.0,9,0.222,1,0.25,6.9,14,6,8,0.429,27,0.519,2,0.56,5.3,16,8,8,0.5,36,0.444,3,0.485,5.5,2014-15
254,201941,Jordan Hill,1610612747,LAL,70,19,51,1874.0,174,117,49,0.672,403,0.432,12,0.445,6.3,382,155,224,0.406,619,0.617,60,0.683,4.3,556,272,273,0.489,1022,0.544,72,0.585,4.9,2014-15
255,203268,Jorge Gutierrez,1610612749,MIL,20,10,10,174.0,5,1,4,0.2,15,0.333,0,0.333,13.2,20,3,17,0.15,35,0.571,3,0.625,7.3,25,4,21,0.16,50,0.5,3,0.532,8.5,2014-15
256,101181,Jose Calderon,1610612752,NYK,41,7,34,1233.0,19,0,19,0.0,51,0.373,1,0.38,20.1,102,10,93,0.098,178,0.573,11,0.611,10.4,121,10,112,0.083,229,0.528,12,0.558,11.9,2014-15
257,201177,Josh McRoberts,1610612748,MIA,17,8,9,296.0,7,5,2,0.714,17,0.412,0,0.412,4.3,38,20,17,0.526,80,0.475,9,0.535,5.4,45,25,19,0.556,97,0.464,9,0.511,5.2,2014-15
258,2746,Josh Smith,1610612745,HOU,83,41,42,2301.0,152,97,56,0.638,334,0.455,10,0.469,8.3,378,143,230,0.378,688,0.549,59,0.601,5.6,530,240,286,0.453,1022,0.519,69,0.556,6.3,2014-15
259,201950,Jrue Holiday,1610612740,NOP,40,20,20,1303.0,32,15,17,0.469,103,0.311,3,0.32,12.2,103,22,83,0.214,211,0.488,15,0.526,7.9,135,37,100,0.274,314,0.43,18,0.456,8.8,2014-15
260,203944,Julius Randle,1610612747,LAL,1,0,1,14.0,0,0,0,0.0,3,0.0,0,0.0,0.0,0,0,0,0.0,1,0.0,0,0.0,0.0,0,0,0,0.0,4,0.0,0,0.0,0.0,2014-15
261,203120,Justin Hamilton,1610612750,MIN,41,6,35,713.0,57,45,11,0.789,124,0.46,1,0.463,5.5,77,31,47,0.403,197,0.391,27,0.453,6.0,134,76,58,0.567,321,0.417,28,0.457,5.8,2014-15
262,203200,Justin Holiday,1610612744,GSW,59,49,10,657.0,12,8,6,0.667,54,0.222,0,0.222,6.7,61,10,49,0.164,112,0.545,10,0.598,10.6,73,18,55,0.247,166,0.44,10,0.468,10.2,2014-15
263,203994,Jusuf Nurkic,1610612743,DEN,62,21,41,1103.0,125,94,27,0.752,308,0.406,8,0.417,4.4,257,119,136,0.463,421,0.61,29,0.656,4.0,382,213,163,0.558,729,0.524,37,0.552,4.2,2014-15
264,203909,KJ McDaniels,1610612745,HOU,62,19,43,1352.0,65,41,20,0.631,135,0.481,5,0.5,7.6,135,40,96,0.296,294,0.459,36,0.523,7.4,200,81,116,0.405,429,0.466,41,0.515,7.5,2014-15
265,203564,Kalin Lucas,1610612763,MEM,1,0,1,6.0,0,0,0,0.0,0,0.0,0,0.0,0.0,0,0,0,0.0,0,0.0,0,0.0,0.0,0,0,0,0.0,0,0.0,0,0.0,0.0,2014-15
266,202695,Kawhi Leonard,1610612759,SAS,64,46,18,2033.0,85,53,32,0.624,186,0.457,9,0.48,9.0,376,104,274,0.277,551,0.682,38,0.733,6.4,461,157,306,0.341,737,0.626,47,0.668,6.9,2014-15
267,203482,Kelly Olynyk,1610612738,BOS,64,31,33,1423.0,92,54,37,0.587,262,0.351,14,0.371,7.8,211,64,142,0.303,404,0.522,43,0.584,5.6,303,118,179,0.389,666,0.455,57,0.498,6.2,2014-15
268,202689,Kemba Walker,1610612766,CHA,62,21,41,2119.0,35,15,19,0.429,172,0.203,5,0.21,16.4,185,37,151,0.2,420,0.44,49,0.499,8.6,220,52,170,0.236,592,0.372,54,0.409,9.8,2014-15
269,203088,Kendall Marshall,1610612749,MIL,27,12,15,414.0,2,0,3,0.0,21,0.095,1,0.1,23.1,25,5,20,0.2,51,0.49,2,0.51,9.6,27,5,23,0.185,72,0.375,3,0.391,11.1,2014-15
270,2570,Kendrick Perkins,1610612739,CLE,68,38,30,1148.0,91,65,24,0.714,241,0.378,12,0.397,6.6,229,92,136,0.402,398,0.575,40,0.64,3.9,320,157,160,0.491,639,0.501,52,0.545,4.7,2014-15
271,202702,Kenneth Faried,1610612743,DEN,75,30,45,2086.0,242,167,68,0.69,560,0.432,16,0.445,6.0,426,167,254,0.392,649,0.656,40,0.7,5.1,668,334,322,0.5,1209,0.553,56,0.579,5.5,2014-15
272,203145,Kent Bazemore,1610612737,ATL,75,53,22,1323.0,21,12,10,0.571,78,0.269,2,0.276,7.7,201,39,158,0.194,341,0.589,33,0.653,6.2,222,51,168,0.23,419,0.53,35,0.578,6.3,2014-15
273,203484,Kentavious Caldwell-Pope,1610612765,DET,82,32,50,2587.0,46,14,34,0.304,172,0.267,8,0.28,12.0,209,40,169,0.191,382,0.547,41,0.613,9.0,255,54,203,0.212,554,0.46,49,0.505,9.5,2014-15
274,2030,Kenyon Martin,1610612749,MIL,10,6,4,102.0,5,3,1,0.6,16,0.313,0,0.313,6.4,13,8,5,0.615,25,0.52,3,0.591,4.1,18,11,6,0.611,41,0.439,3,0.474,4.6,2014-15
275,201142,Kevin Durant,1610612760,OKC,27,18,9,913.0,16,9,6,0.563,60,0.267,2,0.276,10.9,162,39,121,0.241,218,0.743,13,0.79,6.3,178,48,127,0.27,278,0.64,15,0.677,6.7,2014-15
276,708,Kevin Garnett,1610612750,MIN,47,20,27,952.0,48,24,22,0.5,88,0.545,6,0.585,8.1,263,86,178,0.327,367,0.717,23,0.765,4.9,311,110,200,0.354,455,0.684,29,0.73,5.4,2014-15
277,201567,Kevin Love,1610612739,CLE,74,50,24,2493.0,141,85,52,0.603,320,0.441,5,0.448,7.3,585,238,343,0.407,938,0.624,71,0.675,4.2,726,323,395,0.445,1258,0.577,76,0.614,4.8,2014-15
278,2755,Kevin Martin,1610612750,MIN,38,11,27,1280.0,18,6,11,0.333,94,0.191,4,0.2,14.3,119,12,104,0.101,191,0.623,23,0.708,8.2,137,18,115,0.131,285,0.481,27,0.531,9.0,2014-15
279,202338,Kevin Seraphin,1610612764,WAS,79,45,34,1235.0,87,57,27,0.655,210,0.414,5,0.424,6.4,201,72,129,0.358,405,0.496,44,0.557,5.0,288,129,156,0.448,615,0.468,49,0.509,5.4,2014-15
280,203114,Khris Middleton,1610612749,MIL,78,39,39,2345.0,48,26,20,0.542,176,0.273,9,0.287,11.6,293,70,224,0.239,460,0.637,32,0.685,7.0,341,96,244,0.282,636,0.536,41,0.573,7.6,2014-15
281,2550,Kirk Hinrich,1610612741,CHI,66,37,29,1610.0,20,2,18,0.1,82,0.244,2,0.25,19.4,101,24,74,0.238,202,0.5,13,0.534,10.2,121,26,92,0.215,284,0.426,15,0.45,11.8,2014-15
282,202691,Klay Thompson,1610612744,GSW,77,64,13,2455.0,27,14,13,0.519,175,0.154,10,0.164,10.7,220,53,169,0.241,430,0.512,36,0.558,8.3,247,67,182,0.271,605,0.408,46,0.442,8.6,2014-15
283,977,Kobe Bryant,1610612747,LAL,35,10,25,1207.0,26,20,9,0.769,102,0.255,6,0.271,8.6,173,31,142,0.179,279,0.62,22,0.673,7.0,199,51,151,0.256,381,0.522,28,0.564,7.2,2014-15
284,201585,Kosta Koufos,1610612763,MEM,81,55,26,1348.0,121,74,43,0.612,256,0.473,6,0.484,5.5,305,141,163,0.462,488,0.625,45,0.688,4.0,426,215,206,0.505,744,0.573,51,0.615,4.4,2014-15
285,203123,Kostas Papanikolaou,1610612745,HOU,42,28,14,771.0,39,17,20,0.436,105,0.371,4,0.386,10.4,79,26,53,0.329,193,0.409,22,0.462,6.7,118,43,73,0.364,298,0.396,26,0.434,7.9,2014-15
286,2743,Kris Humphries,1610612764,WAS,64,37,27,1345.0,118,75,41,0.636,304,0.388,8,0.399,6.0,298,95,201,0.319,500,0.596,39,0.646,4.7,416,170,242,0.409,804,0.517,47,0.55,5.1,2014-15
287,203937,Kyle Anderson,1610612759,SAS,33,22,11,358.0,5,4,1,0.8,22,0.227,1,0.238,7.1,67,21,45,0.313,109,0.615,6,0.65,6.0,72,25,46,0.347,131,0.55,7,0.581,6.1,2014-15
288,2594,Kyle Korver,1610612737,ATL,75,58,17,2418.0,15,4,12,0.267,102,0.147,4,0.153,22.0,289,88,197,0.304,575,0.503,43,0.543,6.9,304,92,209,0.303,677,0.449,47,0.483,7.7,2014-15
289,200768,Kyle Lowry,1610612761,TOR,70,43,27,2414.0,54,32,23,0.593,268,0.201,13,0.212,10.1,274,51,225,0.186,549,0.499,47,0.546,8.5,328,83,248,0.253,817,0.401,60,0.433,8.9,2014-15
290,203124,Kyle O'Quinn,1610612753,ORL,51,15,36,824.0,46,32,13,0.696,115,0.4,5,0.418,5.6,153,62,91,0.405,268,0.571,26,0.632,4.2,199,94,104,0.472,383,0.52,31,0.565,4.5,2014-15
291,202713,Kyle Singler,1610612760,OKC,80,36,44,1744.0,33,13,20,0.394,147,0.224,1,0.226,12.9,161,43,117,0.267,346,0.465,31,0.511,7.2,194,56,137,0.289,493,0.394,32,0.421,8.2,2014-15
292,202681,Kyrie Irving,1610612739,CLE,74,52,22,2687.0,55,20,39,0.364,253,0.217,13,0.229,13.5,178,32,148,0.18,404,0.441,24,0.468,10.6,233,52,187,0.223,657,0.355,37,0.376,11.4,2014-15
293,200746,LaMarcus Aldridge,1610612757,POR,71,48,23,2512.0,177,120,46,0.678,344,0.515,15,0.538,6.4,549,186,364,0.339,797,0.689,50,0.735,4.9,726,306,410,0.421,1141,0.636,65,0.675,5.3,2014-15
294,202362,Lance Stephenson,1610612766,CHA,61,23,38,1573.0,39,16,22,0.41,164,0.238,5,0.245,9.4,238,33,202,0.139,349,0.682,28,0.741,6.0,277,49,224,0.177,513,0.54,33,0.577,6.4,2014-15
295,202498,Lance Thomas,1610612752,NYK,61,20,41,1473.0,65,30,31,0.462,185,0.351,7,0.365,9.0,126,25,101,0.198,230,0.548,16,0.589,8.5,191,55,132,0.288,415,0.46,23,0.487,8.6,2014-15
296,202361,Landry Fields,1610612761,TOR,26,16,10,216.0,10,5,5,0.5,18,0.556,0,0.556,6.9,16,1,15,0.063,28,0.571,3,0.64,8.1,26,6,20,0.231,46,0.565,3,0.605,7.6,2014-15
297,204038,Langston Galloway,1610612752,NYK,44,12,32,1429.0,37,15,23,0.405,112,0.33,8,0.356,13.8,152,24,130,0.158,257,0.591,23,0.65,9.1,189,39,153,0.206,369,0.512,31,0.559,10.0,2014-15
298,203580,Larry Drew II,1610612755,PHI,12,4,8,219.0,1,0,2,0.0,11,0.091,0,0.091,8.5,14,0,15,0.0,29,0.483,5,0.583,9.2,15,0,17,0.0,40,0.375,5,0.429,9.3,2014-15
299,202336,Larry Sanders,1610612749,MIL,27,12,15,586.0,67,46,18,0.687,142,0.472,4,0.486,4.3,99,49,48,0.495,191,0.518,15,0.563,4.3,166,95,66,0.572,333,0.498,19,0.529,4.3,2014-15
300,202730,Lavoy Allen,1610612754,IND,63,29,34,1070.0,123,78,41,0.634,274,0.449,9,0.464,5.5,200,70,129,0.35,345,0.58,32,0.639,4.8,323,148,170,0.458,619,0.522,41,0.559,5.0,2014-15
301,2544,LeBron James,1610612739,CLE,68,50,18,2453.0,51,27,23,0.529,214,0.238,4,0.243,9.7,361,78,283,0.216,530,0.681,13,0.698,7.5,412,105,306,0.255,744,0.554,17,0.567,7.7,2014-15
302,2571,Leandro Barbosa,1610612744,GSW,66,54,12,982.0,23,10,13,0.435,80,0.288,3,0.299,12.1,68,13,55,0.191,121,0.562,10,0.613,10.5,91,23,68,0.253,201,0.453,13,0.484,10.9,2014-15
303,201991,Lester Hudson,1610612746,LAC,5,5,0,56.0,1,0,1,0.0,6,0.167,0,0.167,7.4,7,4,3,0.571,11,0.636,1,0.7,9.1,8,4,4,0.5,17,0.471,1,0.5,8.9,2014-15
304,203485,Lorenzo Brown,1610612750,MIN,29,6,23,549.0,14,5,9,0.357,47,0.298,4,0.326,11.8,56,12,44,0.214,96,0.583,6,0.622,7.1,70,17,53,0.243,143,0.49,10,0.526,8.1,2014-15
305,200811,Lou Amundson,1610612752,NYK,52,17,35,920.0,93,61,30,0.656,235,0.396,6,0.406,5.1,169,64,103,0.379,340,0.497,34,0.552,4.2,262,125,133,0.477,575,0.456,40,0.49,4.5,2014-15
306,101150,Lou Williams,1610612761,TOR,80,48,32,2016.0,24,12,12,0.5,123,0.195,6,0.205,14.0,127,13,114,0.102,230,0.552,18,0.599,9.9,151,25,126,0.166,353,0.428,24,0.459,10.5,2014-15
307,201601,Luc Mbah a Moute,1610612755,PHI,67,16,51,1916.0,82,49,30,0.598,260,0.315,11,0.329,7.9,246,84,160,0.341,496,0.496,38,0.537,7.3,328,133,190,0.405,756,0.434,49,0.464,7.4,2014-15
308,203512,Lucas Nogueira,1610612761,TOR,6,3,3,23.0,2,2,0,1.0,7,0.286,0,0.286,4.0,9,5,4,0.556,9,1.0,1,1.125,4.8,11,7,4,0.636,16,0.688,1,0.733,4.7,2014-15
309,2449,Luis Scola,1610612754,IND,81,37,44,1659.0,138,91,39,0.659,367,0.376,10,0.387,5.9,388,137,248,0.353,602,0.645,56,0.711,4.3,526,228,287,0.433,969,0.543,66,0.583,4.7,2014-15
310,202337,Luke Babbitt,1610612740,NOP,63,34,29,830.0,12,8,4,0.667,50,0.24,2,0.25,11.4,99,31,70,0.313,192,0.516,17,0.566,5.8,111,39,74,0.351,242,0.459,19,0.498,6.4,2014-15
311,2557,Luke Ridnour,1610612753,ORL,47,13,34,683.0,8,3,4,0.375,30,0.267,0,0.267,8.0,60,9,51,0.15,102,0.588,7,0.632,9.8,68,12,55,0.176,132,0.515,7,0.544,9.6,2014-15
312,2736,Luol Deng,1610612748,MIA,71,32,39,2381.0,100,61,37,0.61,277,0.361,9,0.373,7.4,268,66,203,0.246,491,0.546,50,0.608,7.7,368,127,240,0.345,768,0.479,59,0.519,7.6,2014-15
313,202723,Malcolm Lee,1610612755,PHI,1,0,1,2.0,0,0,0,0.0,0,0.0,0,0.0,0.0,0,0,0,0.0,0,0.0,0,0.0,0.0,0,0,0,0.0,0,0.0,0,0.0,0.0,2014-15
314,202952,Malcolm Thomas,1610612755,PHI,17,2,15,194.0,16,11,5,0.688,37,0.432,1,0.444,4.8,40,18,24,0.45,57,0.702,6,0.784,4.7,56,29,29,0.518,94,0.596,7,0.644,4.7,2014-15
315,1938,Manu Ginobili,1610612759,SAS,70,47,23,1587.0,28,12,16,0.429,137,0.204,6,0.214,14.8,183,49,135,0.268,320,0.572,27,0.625,7.8,211,61,151,0.289,457,0.462,33,0.498,8.7,2014-15
316,201188,Marc Gasol,1610612763,MEM,81,55,26,2687.0,115,90,23,0.783,280,0.411,11,0.428,6.0,515,247,262,0.48,857,0.601,57,0.644,5.0,630,337,285,0.535,1137,0.554,68,0.589,5.2,2014-15
317,101162,Marcin Gortat,1610612764,WAS,82,46,36,2453.0,180,117,61,0.65,437,0.412,18,0.43,5.9,537,169,366,0.315,962,0.558,72,0.603,4.3,717,286,427,0.399,1399,0.513,90,0.548,4.7,2014-15
318,201158,Marco Belinelli,1610612759,SAS,62,41,21,1388.0,26,6,19,0.231,72,0.361,3,0.377,15.1,131,20,111,0.153,228,0.575,12,0.606,8.0,157,26,130,0.166,300,0.523,15,0.551,9.1,2014-15
319,202694,Marcus Morris Sr.,1610612756,PHX,81,39,42,2045.0,73,46,25,0.63,216,0.338,7,0.349,9.4,312,102,211,0.327,518,0.602,32,0.642,5.6,385,148,236,0.384,734,0.525,39,0.554,6.3,2014-15
320,203935,Marcus Smart,1610612738,BOS,67,35,32,1808.0,61,31,26,0.508,169,0.361,6,0.374,10.3,161,42,119,0.261,312,0.516,26,0.563,8.2,222,73,145,0.329,481,0.462,32,0.494,8.7,2014-15
321,201977,Marcus Thornton,1610612756,PHX,48,19,29,721.0,23,6,17,0.261,87,0.264,4,0.277,10.0,63,14,49,0.222,120,0.525,11,0.578,7.4,86,20,66,0.233,207,0.415,15,0.448,8.1,2014-15
322,201596,Mario Chalmers,1610612748,MIA,79,35,44,2337.0,23,7,18,0.304,169,0.136,6,0.141,13.6,182,30,155,0.165,378,0.481,30,0.523,9.4,205,37,173,0.18,547,0.375,36,0.401,9.9,2014-15
323,203900,Markel Brown,1610612751,BKN,47,23,24,781.0,16,7,9,0.438,69,0.232,4,0.246,12.6,91,15,76,0.165,140,0.65,8,0.689,7.6,107,22,85,0.206,209,0.512,12,0.543,8.3,2014-15
324,202693,Markieff Morris,1610612756,PHX,82,39,43,2581.0,110,61,48,0.555,292,0.377,12,0.393,7.9,396,144,248,0.364,727,0.545,75,0.607,5.2,506,205,296,0.405,1019,0.497,87,0.543,5.8,2014-15
325,201578,Marreese Speights,1610612744,GSW,76,62,14,1207.0,109,80,25,0.734,237,0.46,3,0.466,5.0,216,108,106,0.5,422,0.512,41,0.567,4.1,325,188,131,0.578,659,0.493,44,0.528,4.4,2014-15
326,101110,Martell Webster,1610612764,WAS,32,12,20,352.0,10,5,5,0.5,25,0.4,0,0.4,8.6,36,7,28,0.194,58,0.621,5,0.679,6.1,46,12,33,0.261,83,0.554,5,0.59,6.6,2014-15
327,101107,Marvin Williams,1610612766,CHA,78,32,46,2035.0,58,30,24,0.517,152,0.382,7,0.4,10.5,328,91,235,0.277,580,0.566,52,0.621,5.8,386,121,259,0.313,732,0.527,59,0.574,6.5,2014-15
328,203486,Mason Plumlee,1610612751,BKN,82,38,44,1743.0,175,121,46,0.691,413,0.424,11,0.435,5.7,337,149,189,0.442,600,0.562,57,0.621,4.3,512,270,235,0.527,1013,0.505,68,0.542,4.7,2014-15
329,2440,Matt Barnes,1610612746,LAC,76,51,25,2271.0,51,25,23,0.49,166,0.307,11,0.329,11.6,251,59,195,0.235,446,0.563,42,0.621,6.3,302,84,218,0.278,612,0.493,53,0.54,7.1,2014-15
330,2588,Matt Bonner,1610612759,SAS,72,49,23,935.0,29,15,14,0.517,82,0.354,4,0.372,12.3,86,27,59,0.314,210,0.41,19,0.45,6.2,115,42,73,0.365,292,0.394,23,0.428,7.7,2014-15
331,203521,Matthew Dellavedova,1610612739,CLE,66,43,23,1365.0,35,11,24,0.314,108,0.324,3,0.333,14.1,88,14,72,0.159,226,0.389,23,0.433,9.2,123,25,96,0.203,334,0.368,26,0.399,10.7,2014-15
332,203090,Maurice Harkless,1610612753,ORL,45,9,36,674.0,38,22,14,0.579,87,0.437,4,0.458,5.4,68,20,48,0.294,130,0.523,14,0.586,7.6,106,42,62,0.396,217,0.488,18,0.533,6.8,2014-15
333,203086,Meyers Leonard,1610612757,POR,55,32,23,847.0,46,26,21,0.565,129,0.357,4,0.368,8.4,204,69,135,0.338,315,0.648,28,0.711,4.8,250,95,156,0.38,444,0.563,32,0.607,5.5,2014-15
334,201563,Michael Beasley,1610612748,MIA,24,11,13,505.0,12,5,5,0.417,40,0.3,1,0.308,6.0,77,30,47,0.39,137,0.562,10,0.606,5.7,89,35,52,0.393,177,0.503,11,0.536,5.7,2014-15
335,203487,Michael Carter-Williams,1610612749,MIL,66,21,45,2150.0,64,36,27,0.563,233,0.275,8,0.284,11.0,289,64,227,0.221,499,0.579,31,0.618,7.3,353,100,254,0.283,732,0.482,39,0.509,8.0,2014-15
336,203077,Michael Kidd-Gilchrist,1610612766,CHA,55,27,28,1587.0,109,62,46,0.569,297,0.367,10,0.38,8.1,307,89,215,0.29,502,0.612,48,0.676,5.2,416,151,261,0.363,799,0.521,58,0.561,6.0,2014-15
337,201144,Mike Conley,1610612763,MEM,70,47,23,2225.0,29,8,21,0.276,130,0.223,7,0.236,14.0,180,24,159,0.133,353,0.51,33,0.563,9.6,209,32,180,0.153,483,0.433,40,0.472,10.1,2014-15
338,2399,Mike Dunleavy,1610612741,CHI,63,41,22,1838.0,28,17,12,0.607,135,0.207,5,0.215,7.7,220,45,176,0.205,426,0.516,54,0.591,7.4,248,62,188,0.25,561,0.442,59,0.494,7.5,2014-15
339,2034,Mike Miller,1610612739,CLE,51,31,20,675.0,4,1,3,0.25,28,0.143,2,0.154,18.1,87,16,71,0.184,146,0.596,10,0.64,6.9,91,17,74,0.187,174,0.523,12,0.562,7.4,2014-15
340,203488,Mike Muscala,1610612737,ATL,40,26,14,502.0,52,31,20,0.596,103,0.505,1,0.51,7.2,67,27,39,0.403,169,0.396,17,0.441,3.7,119,58,59,0.487,272,0.438,18,0.469,5.2,2014-15
341,203118,Mike Scott,1610612737,ATL,68,52,16,1123.0,45,29,16,0.644,102,0.441,3,0.455,6.9,154,58,96,0.377,275,0.56,20,0.604,5.9,199,87,112,0.437,377,0.528,23,0.562,6.1,2014-15
342,203101,Miles Plumlee,1610612749,MIL,73,34,39,1194.0,112,77,32,0.688,248,0.452,8,0.467,6.2,208,85,121,0.409,428,0.486,43,0.54,3.8,320,162,153,0.506,676,0.473,51,0.512,4.6,2014-15
343,203545,Miroslav Raduljica,1610612750,MIN,5,0,5,23.0,2,1,1,0.5,6,0.333,0,0.333,7.8,3,1,2,0.333,7,0.429,1,0.5,4.6,5,2,3,0.4,13,0.385,1,0.417,5.9,2014-15
344,203141,Mirza Teletovic,1610612751,BKN,40,16,24,892.0,27,18,10,0.667,80,0.338,3,0.351,6.5,167,60,105,0.359,312,0.535,22,0.576,4.9,194,78,115,0.402,392,0.495,25,0.529,5.1,2014-15
345,203956,Mitch McGary,1610612760,OKC,32,20,12,485.0,53,37,16,0.698,114,0.465,0,0.465,6.6,112,40,70,0.357,189,0.593,25,0.683,5.1,165,77,86,0.467,303,0.545,25,0.594,5.6,2014-15
346,2590,Mo Williams,1610612766,CHA,67,20,47,1967.0,22,4,18,0.182,76,0.289,5,0.31,16.6,150,20,134,0.133,293,0.512,22,0.554,9.5,172,24,152,0.14,369,0.466,27,0.503,10.4,2014-15
347,101145,Monta Ellis,1610612742,DAL,80,50,30,2699.0,34,13,20,0.382,185,0.184,9,0.193,11.9,156,26,131,0.167,336,0.464,19,0.492,9.4,190,39,151,0.205,521,0.365,28,0.385,9.8,2014-15
348,101126,Nate Robinson,1610612743,DEN,42,22,20,591.0,17,3,13,0.176,56,0.304,1,0.309,17.6,33,4,30,0.121,67,0.493,2,0.508,14.4,50,7,43,0.14,123,0.407,3,0.417,15.5,2014-15
349,203489,Nate Wolters,1610612749,MIL,21,14,7,247.0,8,5,3,0.625,21,0.381,1,0.4,15.1,26,5,22,0.192,47,0.553,3,0.591,8.2,34,10,25,0.294,68,0.5,4,0.531,9.8,2014-15
350,1737,Nazr Mohammed,1610612741,CHI,23,13,10,128.0,11,8,3,0.727,18,0.611,1,0.647,6.3,27,13,12,0.481,40,0.675,2,0.711,4.3,38,21,15,0.553,58,0.655,3,0.691,4.9,2014-15
351,2403,Nene,1610612764,WAS,67,37,30,1693.0,84,48,36,0.571,251,0.335,12,0.351,8.8,261,114,143,0.437,440,0.593,36,0.646,5.4,345,162,179,0.47,691,0.499,48,0.537,6.2,2014-15
352,203457,Nerlens Noel,1610612755,PHI,75,18,57,2311.0,185,110,70,0.595,449,0.412,13,0.424,6.0,426,168,254,0.394,729,0.584,58,0.635,4.7,611,278,324,0.455,1178,0.519,71,0.552,5.1,2014-15
353,201979,Nick Calathes,1610612763,MEM,58,36,22,838.0,19,12,7,0.632,68,0.279,1,0.284,7.1,87,20,67,0.23,169,0.515,17,0.572,8.3,106,32,74,0.302,237,0.447,18,0.484,8.1,2014-15
354,2555,Nick Collison,1610612760,OKC,66,38,28,1101.0,90,62,27,0.689,204,0.441,6,0.455,5.8,160,74,84,0.463,312,0.513,28,0.563,5.5,250,136,111,0.544,516,0.484,34,0.519,5.6,2014-15
355,203910,Nick Johnson,1610612745,HOU,27,17,10,258.0,13,7,6,0.538,36,0.361,0,0.361,7.1,26,9,16,0.346,55,0.473,5,0.52,7.9,39,16,22,0.41,91,0.429,5,0.453,7.6,2014-15
356,201156,Nick Young,1610612747,LAL,42,12,30,1000.0,17,4,14,0.235,64,0.266,2,0.274,17.9,79,14,65,0.177,132,0.598,13,0.664,9.8,96,18,79,0.188,196,0.49,15,0.53,11.4,2014-15
357,201587,Nicolas Batum,1610612757,POR,71,43,28,2380.0,62,31,31,0.5,201,0.308,5,0.316,10.4,354,63,289,0.178,590,0.6,50,0.656,5.7,416,94,320,0.226,791,0.526,55,0.565,6.4,2014-15
358,203917,Nik Stauskas,1610612758,SAC,73,26,47,1127.0,11,2,10,0.182,66,0.167,2,0.172,16.1,77,14,62,0.182,153,0.503,10,0.538,9.4,88,16,72,0.182,219,0.402,12,0.425,10.3,2014-15
359,202703,Nikola Mirotic,1610612741,CHI,82,50,32,1654.0,63,39,22,0.619,197,0.32,6,0.33,7.4,341,128,211,0.375,549,0.621,40,0.67,4.7,404,167,233,0.413,746,0.542,46,0.577,5.1,2014-15
360,201593,Nikola Pekovic,1610612750,MIN,30,9,21,787.0,85,65,18,0.765,209,0.407,8,0.423,5.1,136,61,75,0.449,227,0.599,22,0.663,4.4,221,126,93,0.57,436,0.507,30,0.544,4.7,2014-15
361,202696,Nikola Vucevic,1610612753,ORL,74,21,53,2529.0,238,158,74,0.664,416,0.572,3,0.576,5.1,572,237,330,0.414,807,0.709,58,0.764,4.2,810,395,404,0.488,1223,0.662,61,0.697,4.5,2014-15
362,203943,Noah Vonleh,1610612766,CHA,25,8,17,259.0,28,21,8,0.75,69,0.406,1,0.412,4.6,58,16,41,0.276,90,0.644,9,0.716,3.9,86,37,49,0.43,159,0.541,10,0.577,4.1,2014-15
363,202708,Norris Cole,1610612740,NOP,74,36,38,1797.0,12,3,8,0.25,94,0.128,9,0.141,18.8,145,18,130,0.124,301,0.482,22,0.52,10.8,157,21,138,0.134,395,0.397,31,0.431,11.3,2014-15
364,201564,O.J. Mayo,1610612749,MIL,70,38,32,1673.0,30,12,19,0.4,119,0.252,7,0.268,14.0,156,34,118,0.218,310,0.503,27,0.551,8.7,186,46,137,0.247,429,0.434,34,0.471,9.6,2014-15
365,203136,Ognjen Kuzmic,1610612744,GSW,16,13,3,72.0,7,7,0,1.0,14,0.5,1,0.538,7.5,10,5,7,0.5,27,0.37,4,0.435,4.1,17,12,7,0.706,41,0.415,5,0.472,5.4,2014-15
366,201600,Omer Asik,1610612740,NOP,76,43,33,1982.0,244,182,56,0.746,562,0.434,14,0.445,4.4,504,213,286,0.423,802,0.628,67,0.686,3.9,748,395,342,0.528,1364,0.548,81,0.583,4.1,2014-15
367,201956,Omri Casspi,1610612758,SAC,67,23,44,1416.0,54,34,18,0.63,208,0.26,6,0.267,7.0,206,36,172,0.175,359,0.574,35,0.636,6.4,260,70,190,0.269,567,0.459,41,0.494,6.5,2014-15
368,203490,Otto Porter Jr.,1610612764,WAS,74,41,33,1432.0,70,34,36,0.486,174,0.402,9,0.424,8.8,151,30,120,0.199,286,0.528,23,0.574,6.8,221,64,156,0.29,460,0.48,32,0.516,7.5,2014-15
369,200782,P.J. Tucker,1610612756,PHX,78,36,42,2383.0,114,79,32,0.693,281,0.406,12,0.424,7.0,388,111,273,0.286,613,0.633,47,0.686,5.6,502,190,305,0.378,894,0.562,59,0.601,5.9,2014-15
370,203798,PJ Hairston,1610612766,CHA,45,19,26,687.0,22,11,11,0.5,73,0.301,1,0.306,13.1,70,13,56,0.186,117,0.598,13,0.673,6.6,92,24,67,0.261,190,0.484,14,0.523,8.2,2014-15
371,203143,Pablo Prigioni,1610612745,HOU,66,25,41,1192.0,30,11,21,0.367,90,0.333,7,0.361,13.7,89,7,84,0.079,178,0.5,6,0.517,10.8,119,18,105,0.151,268,0.444,13,0.467,11.6,2014-15
372,201976,Patrick Beverley,1610612745,HOU,56,35,21,1727.0,67,35,32,0.522,207,0.324,3,0.328,11.6,170,37,130,0.218,331,0.514,37,0.578,8.7,237,72,162,0.304,538,0.441,40,0.476,9.5,2014-15
373,203565,Patrick Christopher,1610612763,MEM,4,2,2,29.0,2,1,1,0.5,5,0.4,1,0.5,11.8,4,1,3,0.25,7,0.571,0,0.571,5.6,6,2,4,0.333,12,0.5,1,0.545,7.7,2014-15
374,202335,Patrick Patterson,1610612761,TOR,81,49,32,2156.0,127,68,58,0.535,241,0.527,2,0.531,8.7,306,118,187,0.386,553,0.553,46,0.604,5.0,433,186,245,0.43,794,0.545,48,0.58,6.1,2014-15
375,201988,Patty Mills,1610612759,SAS,51,37,14,801.0,21,7,14,0.333,65,0.323,0,0.323,15.2,54,12,43,0.222,137,0.394,11,0.429,10.8,75,19,57,0.253,202,0.371,11,0.393,12.0,2014-15
376,2200,Pau Gasol,1610612741,CHI,78,48,30,2681.0,220,127,86,0.577,465,0.473,11,0.485,7.0,699,272,423,0.389,1163,0.601,90,0.651,4.4,919,399,509,0.434,1628,0.564,101,0.602,5.0,2014-15
377,202331,Paul George,1610612754,IND,6,5,1,91.0,4,4,0,1.0,8,0.5,0,0.5,5.3,18,2,16,0.111,26,0.692,1,0.72,6.9,22,6,16,0.273,34,0.647,1,0.667,6.6,2014-15
378,200794,Paul Millsap,1610612737,ATL,73,55,18,2390.0,139,105,32,0.755,366,0.38,8,0.388,5.4,431,187,240,0.434,752,0.573,35,0.601,4.8,570,292,272,0.512,1118,0.51,43,0.53,4.9,2014-15
379,1718,Paul Pierce,1610612764,WAS,73,40,33,1914.0,45,26,15,0.578,125,0.36,8,0.385,9.2,249,46,204,0.185,424,0.587,28,0.629,7.2,294,72,219,0.245,549,0.536,36,0.573,7.5,2014-15
380,203544,Pero Antic,1610612737,ATL,63,46,17,1037.0,58,41,17,0.707,157,0.369,3,0.377,5.0,131,56,75,0.427,275,0.476,21,0.516,5.9,189,97,92,0.513,432,0.438,24,0.463,5.6,2014-15
381,203103,Perry Jones III,1610612760,OKC,43,23,20,631.0,6,3,3,0.5,41,0.146,3,0.158,7.7,70,16,54,0.229,112,0.625,7,0.667,7.4,76,19,57,0.25,153,0.497,10,0.531,7.4,2014-15
382,203515,Phil Pressey,1610612738,BOS,50,22,28,600.0,13,3,9,0.231,63,0.206,0,0.206,17.2,67,10,56,0.149,126,0.532,9,0.573,9.5,80,13,65,0.163,189,0.423,9,0.444,10.7,2014-15
383,203112,Quincy Acy,1610612752,NYK,67,12,55,1283.0,79,46,29,0.582,226,0.35,10,0.366,7.4,222,64,158,0.288,366,0.607,27,0.655,5.1,301,110,187,0.365,592,0.508,37,0.542,5.7,2014-15
384,203113,Quincy Miller,1610612765,DET,10,2,8,120.0,4,1,3,0.25,26,0.154,3,0.174,7.7,16,2,14,0.125,38,0.421,4,0.471,5.0,20,3,17,0.15,64,0.313,7,0.351,5.5,2014-15
385,202347,Quincy Pondexter,1610612740,NOP,75,48,27,1793.0,53,29,26,0.547,178,0.298,8,0.312,11.0,142,28,111,0.197,273,0.52,25,0.573,8.9,195,57,137,0.292,451,0.432,33,0.467,9.5,2014-15
386,200765,Rajon Rondo,1610612742,DAL,68,34,34,2019.0,73,34,37,0.466,220,0.332,3,0.336,9.5,300,44,256,0.147,501,0.599,39,0.649,7.2,373,78,293,0.209,721,0.517,42,0.549,7.7,2014-15
387,201196,Ramon Sessions,1610612764,WAS,64,26,38,1188.0,23,7,15,0.304,79,0.291,4,0.307,13.3,121,16,104,0.132,205,0.59,6,0.608,9.6,144,23,119,0.16,284,0.507,10,0.526,10.2,2014-15
388,200751,Randy Foye,1610612743,DEN,50,15,35,1086.0,9,1,8,0.111,57,0.158,3,0.167,19.4,76,7,71,0.092,161,0.472,14,0.517,11.0,85,8,79,0.094,218,0.39,17,0.423,11.9,2014-15
389,2446,Rasual Butler,1610612764,WAS,75,39,36,1505.0,27,12,15,0.444,76,0.355,6,0.386,15.1,170,38,133,0.224,284,0.599,20,0.644,7.5,197,50,148,0.254,360,0.547,26,0.59,8.6,2014-15
390,203492,Ray McCallum,1610612758,SAC,68,22,46,1436.0,52,24,23,0.462,144,0.361,7,0.38,11.4,128,23,106,0.18,234,0.547,10,0.571,9.7,180,47,129,0.261,378,0.476,17,0.499,10.2,2014-15
391,101109,Raymond Felton,1610612742,DAL,29,14,15,281.0,2,0,2,0.0,15,0.133,1,0.143,19.7,24,3,21,0.125,47,0.511,2,0.533,11.9,26,3,23,0.115,62,0.419,3,0.441,12.5,2014-15
392,203493,Reggie Bullock,1610612756,PHX,36,19,17,338.0,1,1,0,1.0,12,0.083,0,0.083,5.7,49,10,41,0.204,81,0.605,8,0.671,7.3,50,11,41,0.22,93,0.538,8,0.588,7.3,2014-15
393,2501,Reggie Evans,1610612758,SAC,47,16,31,764.0,97,71,25,0.732,255,0.38,11,0.398,5.4,202,69,130,0.342,332,0.608,22,0.652,4.5,299,140,155,0.468,587,0.509,33,0.54,4.8,2014-15
394,202704,Reggie Jackson,1610612765,DET,77,37,40,2268.0,56,14,40,0.25,193,0.29,15,0.315,12.1,271,38,234,0.14,467,0.58,40,0.635,8.4,327,52,274,0.159,660,0.495,55,0.54,9.1,2014-15
395,202130,Reggie Williams,1610612759,SAS,20,15,5,105.0,5,3,2,0.6,10,0.5,1,0.556,12.6,12,3,9,0.25,21,0.571,1,0.6,5.7,17,6,11,0.353,31,0.548,2,0.586,7.7,2014-15
396,2210,Richard Jefferson,1610612742,DAL,74,46,28,1244.0,25,10,13,0.4,106,0.236,4,0.245,11.9,158,42,119,0.266,283,0.558,23,0.608,6.8,183,52,132,0.284,389,0.47,27,0.506,7.4,2014-15
397,203495,Ricky Ledo,1610612752,NYK,17,4,13,244.0,16,9,8,0.563,45,0.356,2,0.372,8.6,20,2,19,0.1,34,0.588,1,0.606,6.0,36,11,27,0.306,79,0.456,3,0.474,7.1,2014-15
398,201937,Ricky Rubio,1610612750,MIN,22,7,15,692.0,19,9,9,0.474,53,0.358,3,0.38,12.5,106,18,89,0.17,168,0.631,13,0.684,7.4,125,27,98,0.216,221,0.566,16,0.61,8.1,2014-15
399,203133,Robbie Hummel,1610612750,MIN,44,5,39,733.0,31,18,12,0.581,95,0.326,3,0.337,7.6,103,34,70,0.33,189,0.545,17,0.599,5.3,134,52,82,0.388,284,0.472,20,0.508,5.8,2014-15
400,203496,Robert Covington,1610612755,PHI,70,18,52,1956.0,65,42,23,0.646,216,0.301,10,0.316,8.1,251,81,168,0.323,472,0.532,42,0.584,6.1,316,123,191,0.389,688,0.459,52,0.497,6.5,2014-15
401,203135,Robert Sacre,1610612747,LAL,67,19,48,1133.0,89,56,32,0.629,212,0.42,8,0.436,6.6,144,46,97,0.319,310,0.465,33,0.52,6.0,233,102,129,0.438,522,0.446,41,0.484,6.2,2014-15
402,201577,Robin Lopez,1610612757,POR,59,38,21,1638.0,190,146,35,0.768,455,0.418,12,0.429,4.6,204,96,109,0.471,484,0.421,61,0.482,5.1,394,242,144,0.614,939,0.42,73,0.455,4.9,2014-15
403,203918,Rodney Hood,1610612762,UTA,50,27,23,1064.0,9,1,8,0.111,56,0.161,4,0.173,15.8,108,21,86,0.194,213,0.507,13,0.54,6.6,117,22,94,0.188,269,0.435,17,0.464,7.3,2014-15
404,201155,Rodney Stuckey,1610612754,IND,71,34,37,1874.0,36,14,22,0.389,147,0.245,4,0.252,15.0,212,28,180,0.132,339,0.625,25,0.675,8.2,248,42,202,0.169,486,0.51,29,0.543,9.2,2014-15
405,101179,Ronnie Price,1610612747,LAL,43,13,30,982.0,19,3,14,0.158,65,0.292,3,0.306,16.4,50,11,40,0.22,128,0.391,9,0.42,11.4,69,14,54,0.203,193,0.358,12,0.381,12.6,2014-15
406,101142,Ronny Turiaf,1610612750,MIN,1,0,1,10.0,0,0,0,0.0,1,0.0,0,0.0,0.0,0,0,0,0.0,0,0.0,0,0.0,0.0,0,0,0,0.0,1,0.0,0,0.0,0.0,2014-15
407,201579,Roy Hibbert,1610612754,IND,76,34,42,1926.0,156,106,44,0.679,360,0.433,4,0.438,5.5,384,125,255,0.326,686,0.56,64,0.617,4.8,540,231,299,0.428,1046,0.516,68,0.552,5.0,2014-15
408,200752,Rudy Gay,1610612758,SAC,68,25,43,2408.0,98,59,35,0.602,297,0.33,8,0.339,8.0,301,74,223,0.246,500,0.602,28,0.638,6.8,399,133,258,0.333,797,0.501,36,0.524,7.1,2014-15
409,203497,Rudy Gobert,1610612762,UTA,82,38,44,2158.0,265,193,63,0.728,531,0.499,10,0.509,5.4,510,200,307,0.392,865,0.59,77,0.647,3.8,775,393,370,0.507,1396,0.555,87,0.592,4.3,2014-15
410,203893,Russ Smith,1610612763,MEM,12,7,5,65.0,1,0,1,0.0,4,0.25,0,0.25,13.9,5,2,3,0.4,9,0.556,0,0.556,7.3,6,2,4,0.333,13,0.462,0,0.462,8.4,2014-15
411,201566,Russell Westbrook,1610612760,OKC,67,40,27,2302.0,124,60,57,0.484,394,0.315,11,0.324,10.0,364,86,282,0.236,530,0.687,22,0.717,8.4,488,146,339,0.299,924,0.528,33,0.548,8.8,2014-15
412,201583,Ryan Anderson,1610612740,NOP,61,33,28,1675.0,108,82,24,0.759,247,0.437,10,0.456,5.5,187,93,91,0.497,335,0.558,31,0.615,5.6,295,175,115,0.593,582,0.507,41,0.545,5.5,2014-15
413,200797,Ryan Hollins,1610612758,SAC,46,13,33,441.0,36,23,9,0.639,88,0.409,0,0.409,4.8,67,23,43,0.343,159,0.421,18,0.475,4.5,103,46,52,0.447,247,0.417,18,0.45,4.6,2014-15
414,203527,Ryan Kelly,1610612747,LAL,52,11,41,1233.0,13,5,8,0.385,74,0.176,2,0.181,9.4,133,29,102,0.218,225,0.591,18,0.643,7.0,146,34,110,0.233,299,0.488,20,0.523,7.3,2014-15
415,2223,Samuel Dalembert,1610612752,NYK,32,5,27,544.0,53,38,13,0.717,107,0.495,1,0.5,6.9,115,54,60,0.47,215,0.535,18,0.584,3.3,168,92,73,0.548,322,0.522,19,0.554,4.4,2014-15
416,203930,Sean Kilpatrick,1610612750,MIN,4,2,2,72.0,1,1,0,1.0,3,0.333,0,0.333,1.4,5,1,4,0.2,13,0.385,0,0.385,6.4,6,2,4,0.333,16,0.375,0,0.375,5.6,2014-15
417,2742,Sebastian Telfair,1610612760,OKC,16,4,12,327.0,2,1,1,0.5,15,0.133,0,0.133,4.3,28,0,28,0.0,38,0.737,0,0.737,12.1,30,1,29,0.033,53,0.566,0,0.566,11.6,2014-15
418,201586,Serge Ibaka,1610612760,OKC,64,35,29,2116.0,135,82,48,0.607,316,0.427,16,0.45,6.5,364,138,224,0.379,717,0.508,70,0.563,4.0,499,220,272,0.441,1033,0.483,86,0.527,4.7,2014-15
419,203508,Sergey Karasev,1610612751,BKN,33,12,21,555.0,22,7,16,0.318,59,0.373,0,0.373,10.1,44,7,37,0.159,91,0.484,12,0.557,6.7,66,14,53,0.212,150,0.44,12,0.478,8.1,2014-15
420,203552,Seth Curry,1610612756,PHX,2,2,0,8.0,0,0,0,0.0,1,0.0,0,0.0,0.0,2,0,2,0.0,3,0.667,0,0.667,6.0,2,0,2,0.0,4,0.5,0,0.5,6.0,2014-15
421,203498,Shabazz Muhammad,1610612750,MIN,37,6,31,851.0,62,42,14,0.677,170,0.365,5,0.376,6.4,91,33,59,0.363,145,0.628,10,0.674,5.9,153,75,73,0.49,315,0.486,15,0.51,6.1,2014-15
422,203894,Shabazz Napier,1610612748,MIA,51,24,27,1012.0,17,8,9,0.471,76,0.224,2,0.23,12.2,96,11,86,0.115,195,0.492,24,0.561,9.8,113,19,95,0.168,271,0.417,26,0.461,10.1,2014-15
423,203499,Shane Larkin,1610612752,NYK,75,16,59,1845.0,29,7,22,0.241,96,0.302,2,0.309,18.1,146,24,126,0.164,317,0.461,43,0.533,8.6,175,31,148,0.177,413,0.424,45,0.476,10.2,2014-15
424,200769,Shannon Brown,1610612748,MIA,5,3,2,89.0,0,0,0,0.0,9,0.0,0,0.0,0.0,1,1,1,1.0,9,0.111,2,0.143,8.3,1,1,1,1.0,18,0.056,2,0.063,8.3,2014-15
425,2733,Shaun Livingston,1610612744,GSW,78,64,14,1468.0,43,19,24,0.442,139,0.309,5,0.321,8.5,140,32,110,0.229,286,0.49,12,0.511,9.4,183,51,134,0.279,425,0.431,17,0.449,9.3,2014-15
426,101183,Shavlik Randolph,1610612756,PHX,21,11,10,126.0,16,13,3,0.813,45,0.356,1,0.364,3.9,22,11,10,0.5,48,0.458,8,0.55,3.7,38,24,13,0.632,93,0.409,9,0.452,3.8,2014-15
427,1890,Shawn Marion,1610612739,CLE,56,36,20,1082.0,61,38,19,0.623,158,0.386,7,0.404,6.7,136,34,101,0.25,226,0.602,14,0.642,6.3,197,72,120,0.365,384,0.513,21,0.543,6.4,2014-15
428,200761,Shawne Williams,1610612765,DET,62,25,37,1060.0,34,13,19,0.382,90,0.378,5,0.4,9.9,127,41,81,0.323,265,0.479,19,0.516,5.4,161,54,100,0.335,355,0.454,24,0.486,6.3,2014-15
429,203963,Shayne Whittington,1610612754,IND,20,9,11,108.0,10,7,3,0.7,25,0.4,0,0.4,5.8,19,5,14,0.263,35,0.543,2,0.576,3.7,29,12,17,0.414,60,0.483,2,0.5,4.4,2014-15
430,202714,Shelvin Mack,1610612737,ATL,55,37,18,833.0,8,2,6,0.25,62,0.129,2,0.133,12.3,71,11,60,0.155,141,0.504,5,0.522,8.5,79,13,66,0.165,203,0.389,7,0.403,8.9,2014-15
431,204021,Sim Bhullar,1610612758,SAC,3,1,2,3.0,0,0,0,0.0,1,0.0,0,0.0,0.0,1,0,1,0.0,1,1.0,0,1.0,5.6,1,0,1,0.0,2,0.5,0,0.5,5.6,2014-15
432,203524,Solomon Hill,1610612754,IND,82,38,44,2381.0,70,44,26,0.629,242,0.289,13,0.306,8.3,244,59,181,0.242,453,0.539,36,0.585,7.7,314,103,207,0.328,695,0.452,49,0.486,7.8,2014-15
433,203915,Spencer Dinwiddie,1610612765,DET,34,12,22,455.0,4,3,1,0.75,28,0.143,0,0.143,10.2,44,6,38,0.136,71,0.62,4,0.657,10.0,48,9,39,0.188,99,0.485,4,0.505,10.0,2014-15
434,201150,Spencer Hawes,1610612746,LAC,73,52,21,1274.0,30,20,11,0.667,113,0.265,2,0.27,7.1,228,82,146,0.36,443,0.515,50,0.58,4.7,258,102,157,0.395,556,0.464,52,0.512,5.0,2014-15
435,201939,Stephen Curry,1610612744,GSW,80,67,13,2613.0,56,22,36,0.393,269,0.208,9,0.215,11.9,285,57,230,0.2,567,0.503,33,0.534,9.4,341,79,266,0.232,836,0.408,42,0.429,9.8,2014-15
436,2581,Steve Blake,1610612757,POR,81,51,30,1529.0,16,5,11,0.313,57,0.281,0,0.281,17.0,121,10,112,0.083,285,0.425,28,0.471,10.5,137,15,123,0.109,342,0.401,28,0.436,11.2,2014-15
437,200779,Steve Novak,1610612760,OKC,35,12,23,197.0,2,0,2,0.0,7,0.286,0,0.286,22.4,20,5,14,0.25,44,0.455,4,0.5,5.9,22,5,16,0.227,51,0.431,4,0.468,7.5,2014-15
438,203500,Steven Adams,1610612760,OKC,70,37,33,1771.0,199,146,47,0.734,495,0.402,15,0.415,5.2,324,120,200,0.37,551,0.588,47,0.643,4.2,523,266,247,0.509,1046,0.5,62,0.532,4.6,2014-15
439,203933,T.J. Warren,1610612756,PHX,40,17,23,614.0,41,26,15,0.634,103,0.398,2,0.406,6.7,44,15,29,0.341,96,0.458,3,0.473,7.2,85,41,44,0.482,199,0.427,5,0.438,7.0,2014-15
440,201959,Taj Gibson,1610612741,CHI,62,38,24,1692.0,162,122,36,0.753,377,0.43,16,0.449,5.5,234,88,143,0.376,461,0.508,44,0.561,6.0,396,210,179,0.53,838,0.473,60,0.509,5.8,2014-15
441,204028,Tarik Black,1610612747,LAL,62,24,38,1178.0,138,89,47,0.645,292,0.473,3,0.478,5.7,224,87,136,0.388,405,0.553,39,0.612,4.8,362,176,183,0.486,697,0.519,42,0.553,5.1,2014-15
442,2419,Tayshaun Prince,1610612765,DET,58,27,31,1397.0,52,25,27,0.481,124,0.419,5,0.437,8.9,158,49,105,0.31,261,0.605,23,0.664,7.1,210,74,132,0.352,385,0.545,28,0.588,7.6,2014-15
443,203093,Terrence Jones,1610612745,HOU,33,24,9,889.0,78,53,21,0.679,167,0.467,4,0.479,6.1,142,50,90,0.352,267,0.532,16,0.566,5.9,220,103,111,0.468,434,0.507,20,0.531,5.9,2014-15
444,203082,Terrence Ross,1610612761,TOR,82,49,33,2092.0,32,6,26,0.188,94,0.34,5,0.36,17.7,194,43,149,0.222,360,0.539,18,0.567,7.0,226,49,175,0.217,454,0.498,23,0.524,8.5,2014-15
445,200757,Thabo Sefolosha,1610612737,ATL,52,43,9,976.0,53,25,28,0.472,134,0.396,5,0.411,10.0,170,30,138,0.176,247,0.688,23,0.759,6.9,223,55,166,0.247,381,0.585,28,0.632,7.6,2014-15
446,201152,Thaddeus Young,1610612751,BKN,75,25,50,2407.0,126,82,41,0.651,337,0.374,13,0.389,8.0,282,87,197,0.309,536,0.526,35,0.563,7.2,408,169,238,0.414,873,0.467,48,0.495,7.4,2014-15
447,203080,Thomas Robinson,1610612755,PHI,54,26,28,798.0,95,69,28,0.726,257,0.37,10,0.385,5.6,208,94,114,0.452,313,0.665,24,0.72,4.8,303,163,142,0.538,570,0.532,34,0.565,5.1,2014-15
448,201168,Tiago Splitter,1610612759,SAS,52,34,18,1030.0,91,64,24,0.703,210,0.433,5,0.444,5.2,161,68,94,0.422,300,0.537,35,0.608,4.8,252,132,118,0.524,510,0.494,40,0.536,4.9,2014-15
449,1495,Tim Duncan,1610612759,SAS,77,53,24,2227.0,170,110,56,0.647,389,0.437,17,0.457,7.0,534,234,292,0.438,884,0.604,69,0.655,4.2,704,344,348,0.489,1273,0.553,86,0.593,4.9,2014-15
450,204025,Tim Frazier,1610612757,POR,11,3,8,239.0,6,1,5,0.167,27,0.222,0,0.222,12.6,22,6,16,0.273,57,0.386,13,0.5,7.1,28,7,21,0.25,84,0.333,13,0.394,8.3,2014-15
451,203501,Tim Hardaway Jr.,1610612752,NYK,69,16,53,1656.0,12,5,7,0.417,95,0.126,3,0.13,15.6,140,38,104,0.271,254,0.551,15,0.586,9.4,152,43,111,0.283,349,0.436,18,0.459,9.9,2014-15
452,202389,Timofey Mozgov,1610612739,CLE,81,49,32,2046.0,203,133,65,0.655,500,0.406,14,0.418,5.5,388,192,195,0.495,716,0.542,69,0.6,4.0,591,325,260,0.55,1216,0.486,83,0.522,4.5,2014-15
453,202699,Tobias Harris,1610612753,ORL,68,20,48,2369.0,73,42,28,0.575,231,0.316,6,0.324,8.7,357,91,266,0.255,523,0.683,33,0.729,6.1,430,133,294,0.309,754,0.57,39,0.601,6.5,2014-15
454,201962,Toney Douglas,1610612740,NOP,12,7,5,177.0,2,1,1,0.5,13,0.154,0,0.154,10.8,20,2,18,0.1,35,0.571,3,0.625,8.3,22,3,19,0.136,48,0.458,3,0.489,8.5,2014-15
455,2754,Tony Allen,1610612763,MEM,63,46,17,1648.0,103,72,29,0.699,323,0.319,10,0.329,5.2,177,41,136,0.232,272,0.651,16,0.691,7.3,280,113,165,0.404,595,0.471,26,0.492,6.5,2014-15
456,2225,Tony Parker,1610612759,SAS,68,48,20,1953.0,15,6,11,0.4,143,0.105,7,0.11,17.4,114,14,100,0.123,237,0.481,17,0.518,10.5,129,20,111,0.155,380,0.339,24,0.362,11.3,2014-15
457,203503,Tony Snell,1610612741,CHI,72,43,29,1412.0,31,9,22,0.29,98,0.316,5,0.333,13.1,145,35,112,0.241,265,0.547,20,0.592,8.0,176,44,134,0.25,363,0.485,25,0.521,8.9,2014-15
458,203100,Tony Wroten,1610612755,PHI,30,4,26,895.0,22,16,8,0.727,111,0.198,4,0.206,9.3,64,12,52,0.188,133,0.481,10,0.52,7.9,86,28,60,0.326,244,0.352,14,0.374,8.3,2014-15
459,203315,Toure' Murry,1610612762,UTA,5,3,2,18.0,1,0,1,0.0,2,0.5,0,0.5,9.0,0,0,0,0.0,3,0.0,1,0.0,0.0,1,0,1,0.0,5,0.2,1,0.25,9.0,2014-15
460,204037,Travis Wear,1610612752,NYK,50,7,43,651.0,30,17,13,0.567,95,0.316,5,0.333,8.2,72,16,55,0.222,160,0.45,17,0.503,6.2,102,33,68,0.324,255,0.4,22,0.438,6.8,2014-15
461,2772,Trevor Ariza,1610612745,HOU,81,55,26,2896.0,76,35,36,0.461,303,0.251,15,0.264,11.8,378,90,286,0.238,617,0.613,53,0.67,5.9,454,125,322,0.275,920,0.493,68,0.533,6.8,2014-15
462,202344,Trevor Booker,1610612762,UTA,79,37,42,1564.0,139,76,61,0.547,298,0.466,12,0.486,7.4,258,91,164,0.353,432,0.597,35,0.65,5.0,397,167,225,0.421,730,0.544,47,0.581,5.8,2014-15
463,203504,Trey Burke,1610612762,UTA,76,35,41,2288.0,31,6,29,0.194,143,0.217,5,0.225,15.0,173,22,155,0.127,338,0.512,21,0.546,11.2,204,28,184,0.137,481,0.424,26,0.448,12.0,2014-15
464,202684,Tristan Thompson,1610612739,CLE,81,53,28,2168.0,270,203,58,0.752,673,0.401,22,0.415,4.8,378,134,243,0.354,665,0.568,54,0.619,5.0,648,337,301,0.52,1338,0.484,76,0.513,4.9,2014-15
465,203584,Troy Daniels,1610612766,CHA,46,14,32,392.0,8,3,5,0.375,28,0.286,1,0.296,12.0,25,5,22,0.2,61,0.41,10,0.49,5.9,33,8,27,0.242,89,0.371,11,0.423,7.3,2014-15
466,201951,Ty Lawson,1610612743,DEN,75,29,46,2665.0,42,7,35,0.167,184,0.228,11,0.243,18.8,192,24,171,0.125,341,0.563,22,0.602,11.4,234,31,206,0.132,525,0.446,33,0.476,12.7,2014-15
467,203898,Tyler Ennis,1610612749,MIL,33,11,22,411.0,7,3,4,0.429,21,0.333,0,0.333,7.6,28,6,23,0.214,58,0.483,5,0.528,7.4,35,9,27,0.257,79,0.443,5,0.473,7.4,2014-15
468,201946,Tyler Hansbrough,1610612761,TOR,74,45,29,1058.0,106,78,26,0.736,240,0.442,10,0.461,5.7,159,64,93,0.403,291,0.546,14,0.574,5.5,265,142,119,0.536,531,0.499,24,0.523,5.6,2014-15
469,204020,Tyler Johnson,1610612748,MIA,32,15,17,603.0,14,12,2,0.857,61,0.23,2,0.237,7.1,67,19,48,0.284,130,0.515,9,0.554,9.2,81,31,50,0.383,191,0.424,11,0.45,8.8,2014-15
470,203092,Tyler Zeller,1610612738,BOS,82,40,42,1731.0,146,103,43,0.705,400,0.365,11,0.375,5.6,319,146,174,0.458,596,0.535,58,0.593,5.1,465,249,217,0.535,996,0.467,69,0.502,5.3,2014-15
471,201936,Tyreke Evans,1610612740,NOP,79,43,36,2690.0,82,51,29,0.622,340,0.241,15,0.252,8.8,334,67,266,0.201,562,0.594,40,0.64,7.3,416,118,295,0.284,902,0.461,55,0.491,7.6,2014-15
472,200748,Tyrus Thomas,1610612763,MEM,2,2,0,7.0,0,0,0,0.0,0,0.0,0,0.0,0.0,0,0,0,0.0,0,0.0,0,0.0,0.0,0,0,0,0.0,0,0.0,0,0.0,0.0,2014-15
473,2199,Tyson Chandler,1610612742,DAL,75,47,28,2286.0,294,211,76,0.718,549,0.536,9,0.544,5.3,570,216,345,0.379,957,0.596,71,0.643,4.2,864,427,421,0.494,1506,0.574,80,0.606,4.6,2014-15
474,2617,Udonis Haslem,1610612748,MIA,61,30,31,982.0,70,47,25,0.671,203,0.345,6,0.355,6.4,184,73,110,0.397,336,0.548,33,0.607,4.5,254,120,135,0.472,539,0.471,39,0.508,5.0,2014-15
475,203505,Vander Blue,1610612747,LAL,2,0,2,74.0,2,0,2,0.0,7,0.286,0,0.286,3.3,7,1,6,0.143,13,0.538,0,0.538,9.2,9,1,8,0.111,20,0.45,0,0.45,7.9,2014-15
476,201964,Victor Claver,1610612757,POR,10,6,4,76.0,3,3,0,1.0,4,0.75,0,0.75,5.6,17,13,4,0.765,26,0.654,2,0.708,5.2,20,16,4,0.8,30,0.667,2,0.714,5.2,2014-15
477,203506,Victor Oladipo,1610612753,ORL,72,22,50,2573.0,51,24,27,0.471,257,0.198,19,0.214,9.7,251,62,188,0.247,480,0.523,40,0.57,7.4,302,86,215,0.285,737,0.41,59,0.445,7.8,2014-15
478,1713,Vince Carter,1610612763,MEM,66,45,21,1091.0,27,17,10,0.63,91,0.297,2,0.303,7.7,106,28,77,0.264,220,0.482,26,0.546,6.9,133,45,87,0.338,311,0.428,28,0.47,7.0,2014-15
479,201961,Wayne Ellington,1610612747,LAL,65,18,47,1675.0,31,11,19,0.355,121,0.256,1,0.258,14.6,179,30,149,0.168,296,0.605,22,0.653,8.2,210,41,168,0.195,417,0.504,23,0.533,9.2,2014-15
480,202325,Wesley Johnson,1610612747,LAL,76,20,56,2245.0,67,30,35,0.448,211,0.318,6,0.327,9.8,252,53,192,0.21,419,0.601,35,0.656,6.8,319,83,227,0.26,630,0.506,41,0.542,7.5,2014-15
481,202083,Wesley Matthews,1610612757,POR,60,41,19,2024.0,38,13,25,0.342,126,0.302,5,0.314,14.1,184,38,147,0.207,356,0.517,37,0.577,7.5,222,51,172,0.23,482,0.461,42,0.505,8.6,2014-15
482,203115,Will Barton,1610612743,DEN,58,30,28,984.0,26,14,12,0.538,108,0.241,1,0.243,13.1,136,22,114,0.162,224,0.607,20,0.667,5.8,162,36,126,0.222,332,0.488,21,0.521,7.0,2014-15
483,101198,Will Bynum,1610612764,WAS,7,4,3,67.0,2,0,2,0.0,5,0.4,1,0.5,19.8,4,0,4,0.0,7,0.571,0,0.571,8.4,6,0,6,0.0,12,0.5,1,0.545,12.2,2014-15
484,203805,Will Cherry,1610612761,TOR,8,6,2,69.0,1,1,0,1.0,5,0.2,0,0.2,3.8,4,1,3,0.25,13,0.308,1,0.333,10.8,5,2,3,0.4,18,0.278,1,0.294,9.4,2014-15
485,2584,Willie Green,1610612753,ORL,52,15,37,951.0,14,6,7,0.429,53,0.264,4,0.286,13.3,65,14,51,0.215,137,0.474,15,0.533,9.0,79,20,58,0.253,190,0.416,19,0.462,9.7,2014-15
486,201163,Wilson Chandler,1610612743,DEN,78,28,50,2471.0,96,65,24,0.677,287,0.334,4,0.339,6.2,379,105,274,0.277,629,0.603,54,0.659,5.3,475,170,298,0.358,916,0.519,58,0.554,5.5,2014-15
487,202333,Xavier Henry,1610612747,LAL,9,1,8,86.0,2,0,2,0.0,7,0.286,0,0.286,14.7,2,0,2,0.0,11,0.182,3,0.25,3.1,4,0,4,0.0,18,0.222,3,0.267,8.9,2014-15
488,203897,Zach LaVine,1610612750,MIN,76,15,61,1867.0,27,10,19,0.37,126,0.214,4,0.221,11.5,184,32,150,0.174,336,0.548,26,0.594,7.5,211,42,169,0.199,462,0.457,30,0.488,8.1,2014-15
489,2216,Zach Randolph,1610612763,MEM,71,51,20,2304.0,225,190,28,0.844,552,0.408,12,0.417,4.3,522,169,349,0.324,818,0.638,58,0.687,4.7,747,359,377,0.481,1370,0.545,70,0.575,4.5,2014-15
490,2585,Zaza Pachulia,1610612749,MIL,72,33,39,1702.0,190,131,53,0.689,431,0.441,19,0.461,5.6,296,122,172,0.412,527,0.562,60,0.634,4.5,486,253,225,0.521,958,0.507,79,0.553,4.9,2014-15
491,204054,Zoran Dragic,1610612748,MIA,16,6,10,75.0,5,2,3,0.4,15,0.333,1,0.357,13.5,3,1,2,0.333,8,0.375,2,0.5,7.7,8,3,5,0.375,23,0.348,3,0.4,11.4,2014-15
0,201166,Aaron Brooks,1610612741,CHI,69,36,33,1108.0,21,8,13,0.381,107,0.196,6,0.208,13.7,80,14,66,0.175,160,0.5,13,0.544,10.7,101,22,79,0.218,267,0.378,19,0.407,11.3,2015-16
1,203932,Aaron Gordon,1610612753,ORL,77,32,45,1857.0,154,113,36,0.734,318,0.484,6,0.494,5.7,352,112,235,0.318,517,0.681,34,0.729,5.3,506,225,271,0.445,835,0.606,40,0.636,5.4,2015-16
2,1626151,Aaron Harrison,1610612766,CHA,21,15,6,93.0,4,1,2,0.25,7,0.571,0,0.571,14.1,11,0,11,0.0,19,0.579,2,0.647,8.8,15,1,13,0.067,26,0.577,2,0.625,9.9,2015-16
3,203940,Adreian Payne,1610612750,MIN,52,18,34,486.0,20,13,7,0.65,49,0.408,4,0.444,6.1,91,30,61,0.33,143,0.636,7,0.669,5.2,111,43,68,0.387,192,0.578,11,0.613,5.3,2015-16
4,201143,Al Horford,1610612737,ATL,82,48,34,2631.0,148,88,56,0.595,329,0.45,4,0.455,7.3,448,160,285,0.357,865,0.518,75,0.567,6.0,596,248,341,0.416,1194,0.499,79,0.535,6.3,2015-16
5,2744,Al Jefferson,1610612766,CHA,47,33,14,1096.0,57,35,22,0.614,157,0.363,8,0.383,5.9,244,68,175,0.279,388,0.629,40,0.701,4.0,301,103,197,0.342,545,0.552,48,0.606,4.4,2015-16
6,202329,Al-Farouq Aminu,1610612757,POR,82,44,38,2341.0,98,49,45,0.5,270,0.363,12,0.38,8.8,401,116,284,0.289,641,0.626,48,0.676,6.0,499,165,329,0.331,911,0.548,60,0.586,6.5,2015-16
7,101187,Alan Anderson,1610612764,WAS,13,8,5,192.0,1,0,1,0.0,15,0.067,0,0.067,35.4,26,5,21,0.192,48,0.542,6,0.619,5.7,27,5,22,0.185,63,0.429,6,0.474,6.8,2015-16
8,1626210,Alan Williams,1610612756,PHX,10,3,7,68.0,14,11,2,0.786,31,0.452,2,0.483,4.9,24,11,13,0.458,30,0.8,1,0.828,3.3,38,22,15,0.579,61,0.623,3,0.655,3.8,2015-16
9,202692,Alec Burks,1610612762,UTA,31,13,18,797.0,16,4,11,0.25,84,0.19,2,0.195,14.3,93,21,73,0.226,177,0.525,12,0.564,7.5,109,25,84,0.229,261,0.418,14,0.441,8.4,2015-16
10,203458,Alex Len,1610612756,PHX,78,23,55,1821.0,178,118,50,0.663,424,0.42,9,0.429,5.9,416,148,264,0.356,701,0.593,56,0.645,4.2,594,266,314,0.448,1125,0.528,65,0.56,4.7,2015-16
11,1627293,Alex Stepheson,1610612763,MEM,8,2,6,72.0,19,14,5,0.737,34,0.559,0,0.559,4.5,9,5,4,0.556,22,0.409,4,0.5,5.2,28,19,9,0.679,56,0.5,4,0.538,4.7,2015-16
12,201582,Alexis Ajinca,1610612740,NOP,59,20,39,861.0,75,51,22,0.68,153,0.49,3,0.5,5.4,194,62,131,0.32,319,0.608,27,0.664,4.0,269,113,153,0.42,472,0.57,30,0.609,4.4,2015-16
13,203459,Allen Crabbe,1610612757,POR,81,43,38,2105.0,27,8,19,0.296,117,0.231,3,0.237,14.5,189,38,148,0.201,314,0.602,38,0.685,7.6,216,46,167,0.213,431,0.501,41,0.554,8.5,2015-16
14,202087,Alonzo Gee,1610612740,NOP,73,27,46,1632.0,60,28,29,0.467,189,0.317,3,0.323,7.5,185,54,129,0.292,318,0.582,25,0.631,7.0,245,82,158,0.335,507,0.483,28,0.511,7.1,2015-16
15,2405,Amar'e Stoudemire,1610612748,MIA,52,30,22,762.0,65,53,12,0.815,155,0.419,0,0.419,4.7,157,42,115,0.268,307,0.511,27,0.561,4.2,222,95,127,0.428,462,0.481,27,0.51,4.3,2015-16
16,101161,Amir Johnson,1610612738,BOS,78,44,34,1777.0,177,120,54,0.678,381,0.465,6,0.472,5.8,321,141,176,0.439,592,0.542,60,0.603,4.9,498,261,230,0.524,973,0.512,66,0.549,5.2,2015-16
17,2760,Anderson Varejao,1610612744,GSW,53,41,12,496.0,37,22,14,0.595,99,0.374,4,0.389,5.9,104,34,69,0.327,169,0.615,13,0.667,4.1,141,56,83,0.397,268,0.526,17,0.562,4.6,2015-16
18,203083,Andre Drummond,1610612765,DET,81,43,38,2665.0,395,290,83,0.734,700,0.564,7,0.57,4.8,803,329,470,0.41,1133,0.709,76,0.76,3.4,1198,619,553,0.517,1833,0.654,83,0.685,3.8,2015-16
19,2738,Andre Iguodala,1610612744,GSW,65,59,6,1732.0,52,25,27,0.481,124,0.419,3,0.43,12.1,211,43,168,0.204,343,0.615,24,0.661,8.4,263,68,195,0.259,467,0.563,27,0.598,9.1,2015-16
20,1889,Andre Miller,1610612759,SAS,39,20,19,461.0,12,7,5,0.583,36,0.333,1,0.343,7.2,39,8,31,0.205,77,0.506,3,0.527,9.5,51,15,36,0.294,113,0.451,4,0.468,8.9,2015-16
21,203460,Andre Roberson,1610612760,OKC,70,48,22,1553.0,79,53,26,0.671,216,0.366,8,0.38,7.3,172,47,128,0.273,314,0.548,23,0.591,6.5,251,100,154,0.398,530,0.474,31,0.503,6.8,2015-16
22,200745,Andrea Bargnani,1610612751,BKN,46,11,35,634.0,28,16,11,0.571,58,0.483,0,0.483,7.2,69,25,46,0.362,143,0.483,7,0.507,5.7,97,41,57,0.423,201,0.483,7,0.5,6.1,2015-16
23,101106,Andrew Bogut,1610612744,GSW,70,62,8,1451.0,121,91,29,0.752,202,0.599,3,0.608,5.1,371,146,224,0.394,645,0.575,56,0.63,3.9,492,237,253,0.482,847,0.581,59,0.624,4.2,2015-16
24,202726,Andrew Goudelock,1610612745,HOU,8,5,3,50.0,1,1,0,1.0,4,0.25,0,0.25,28.9,1,1,0,1.0,8,0.125,1,0.143,5.0,2,2,0,1.0,12,0.167,1,0.182,16.9,2015-16
25,203094,Andrew Nicholson,1610612753,ORL,55,22,33,820.0,34,16,17,0.471,87,0.391,4,0.41,8.3,167,70,97,0.419,256,0.652,13,0.687,4.1,201,86,114,0.428,343,0.586,17,0.617,4.8,2015-16
26,203952,Andrew Wiggins,1610612750,MIN,81,29,52,2845.0,105,62,42,0.59,351,0.299,13,0.311,8.0,186,56,132,0.301,355,0.524,15,0.547,8.3,291,118,174,0.405,706,0.412,28,0.429,8.2,2015-16
27,203461,Anthony Bennett,1610612761,TOR,19,12,7,84.0,6,5,1,0.833,16,0.375,0,0.375,5.6,17,4,13,0.235,21,0.81,1,0.85,5.2,23,9,14,0.391,37,0.622,1,0.639,5.3,2015-16
28,1626148,Anthony Brown,1610612747,LAL,29,4,25,599.0,9,2,8,0.222,43,0.209,3,0.225,17.5,61,15,48,0.246,112,0.545,9,0.592,7.2,70,17,56,0.243,155,0.452,12,0.49,8.6,2015-16
29,203076,Anthony Davis,1610612740,NOP,61,24,37,2164.0,130,88,36,0.677,250,0.52,4,0.528,6.7,497,170,323,0.342,667,0.745,34,0.785,4.9,627,258,359,0.411,917,0.684,38,0.713,5.3,2015-16
30,201627,Anthony Morrow,1610612760,OKC,68,46,22,926.0,10,3,9,0.3,41,0.244,0,0.244,14.5,52,18,34,0.346,104,0.5,6,0.531,9.3,62,21,43,0.339,145,0.428,6,0.446,10.5,2015-16
31,201229,Anthony Tolliver,1610612765,DET,72,36,36,1341.0,39,13,23,0.333,100,0.39,3,0.402,13.3,190,53,132,0.279,335,0.567,38,0.64,5.9,229,66,155,0.288,435,0.526,41,0.581,7.1,2015-16
32,203462,Archie Goodwin,1610612756,PHX,57,14,43,1114.0,27,13,11,0.481,137,0.197,10,0.213,8.4,115,26,90,0.226,197,0.584,18,0.642,6.7,142,39,101,0.275,334,0.425,28,0.464,7.0,2015-16
33,203382,Aron Baynes,1610612765,DET,81,43,38,1233.0,140,98,38,0.7,342,0.409,5,0.415,5.4,244,102,144,0.418,421,0.58,40,0.64,4.7,384,200,182,0.521,763,0.503,45,0.535,5.0,2015-16
34,201167,Arron Afflalo,1610612752,NYK,71,27,44,2371.0,23,8,16,0.348,151,0.152,6,0.159,15.3,243,27,217,0.111,418,0.581,34,0.633,8.5,266,35,233,0.132,569,0.467,40,0.503,9.1,2015-16
35,203085,Austin Rivers,1610612746,LAC,67,42,25,1464.0,22,11,11,0.5,101,0.218,3,0.224,11.5,108,13,97,0.12,257,0.42,22,0.46,8.9,130,24,108,0.185,358,0.363,25,0.39,9.4,2015-16
36,202340,Avery Bradley,1610612738,BOS,75,44,31,2507.0,48,14,34,0.292,161,0.298,5,0.308,13.2,169,16,153,0.095,342,0.494,26,0.535,7.6,217,30,187,0.138,503,0.431,31,0.46,8.8,2015-16
37,1626253,Axel Toupane,1610612743,DEN,21,9,12,305.0,8,2,6,0.25,22,0.364,0,0.364,12.2,23,3,19,0.13,48,0.479,2,0.5,11.7,31,5,25,0.161,70,0.443,2,0.456,11.8,2015-16
38,203463,Ben McLemore,1610612758,SAC,67,28,39,1418.0,33,12,21,0.364,121,0.273,8,0.292,11.2,111,15,96,0.135,251,0.442,34,0.512,8.2,144,27,117,0.188,372,0.387,42,0.436,8.9,2015-16
39,2757,Beno Udrih,1610612763,MEM,44,26,18,708.0,8,0,8,0.0,48,0.167,3,0.178,17.3,64,10,56,0.156,125,0.512,11,0.561,11.2,72,10,64,0.139,173,0.416,14,0.453,11.8,2015-16
40,202687,Bismack Biyombo,1610612761,TOR,81,55,26,1787.0,180,132,47,0.733,439,0.41,11,0.421,5.2,469,183,286,0.39,775,0.605,65,0.661,3.9,649,315,333,0.485,1214,0.535,76,0.57,4.2,2015-16
41,201933,Blake Griffin,1610612746,LAC,35,22,13,1170.0,51,31,17,0.608,130,0.392,11,0.429,6.8,243,88,152,0.362,412,0.59,23,0.625,5.1,294,119,169,0.405,542,0.542,34,0.579,5.3,2015-16
42,1626246,Boban Marjanovic,1610612759,SAS,54,47,7,508.0,73,59,9,0.808,134,0.545,5,0.566,3.9,121,49,71,0.405,183,0.661,10,0.699,3.7,194,108,80,0.557,317,0.612,15,0.642,3.7,2015-16
43,1626171,Bobby Portis,1610612741,CHI,62,29,33,1102.0,123,80,41,0.65,283,0.435,8,0.447,5.6,214,62,154,0.29,342,0.626,26,0.677,4.6,337,142,195,0.421,625,0.539,34,0.57,5.0,2015-16
44,202711,Bojan Bogdanovic,1610612751,BKN,79,21,58,2115.0,36,15,21,0.417,185,0.195,11,0.207,13.3,219,36,178,0.164,334,0.656,22,0.702,7.9,255,51,199,0.2,519,0.491,33,0.525,8.7,2015-16
45,2564,Boris Diaw,1610612759,SAS,76,64,12,1386.0,58,27,32,0.466,159,0.365,5,0.377,8.8,175,66,108,0.377,344,0.509,30,0.557,5.6,233,93,140,0.399,503,0.463,35,0.498,6.4,2015-16
46,203078,Bradley Beal,1610612764,WAS,55,28,27,1708.0,41,20,22,0.488,143,0.287,6,0.299,14.1,147,31,113,0.211,234,0.628,7,0.648,7.5,188,51,135,0.271,377,0.499,13,0.516,9.0,2015-16
47,201148,Brandan Wright,1610612763,MEM,12,6,6,212.0,14,11,3,0.786,35,0.4,0,0.4,5.9,29,12,16,0.414,55,0.527,4,0.569,6.0,43,23,19,0.535,90,0.478,4,0.5,6.0,2015-16
48,1626183,Branden Dawson,1610612746,LAC,6,5,1,29.0,2,1,1,0.5,5,0.4,0,0.4,8.8,2,2,0,1.0,9,0.222,2,0.286,3.9,4,3,1,0.75,14,0.286,2,0.333,6.3,2015-16
49,101138,Brandon Bass,1610612747,LAL,66,16,50,1342.0,104,59,43,0.567,248,0.419,6,0.43,7.7,181,51,126,0.282,344,0.526,29,0.575,6.2,285,110,169,0.386,592,0.481,35,0.512,6.7,2015-16
50,201943,Brandon Jennings,1610612753,ORL,48,20,28,867.0,16,5,10,0.313,47,0.34,0,0.34,15.7,80,6,76,0.075,145,0.552,14,0.611,9.0,96,11,86,0.115,192,0.5,14,0.539,10.0,2015-16
51,202688,Brandon Knight,1610612756,PHX,52,16,36,1870.0,36,11,23,0.306,128,0.281,7,0.298,15.8,166,27,138,0.163,320,0.519,20,0.553,8.1,202,38,161,0.188,448,0.451,27,0.48,9.4,2015-16
52,201575,Brandon Rush,1610612744,GSW,72,63,9,1055.0,21,8,12,0.381,65,0.323,2,0.333,12.1,160,46,113,0.288,267,0.599,26,0.664,6.3,181,54,125,0.298,332,0.545,28,0.595,6.9,2015-16
53,203148,Brian Roberts,1610612757,POR,51,26,25,470.0,6,0,5,0.0,22,0.273,0,0.273,24.8,35,2,33,0.057,64,0.547,2,0.565,8.4,41,2,38,0.049,86,0.477,2,0.488,10.5,2015-16
54,1627362,Briante Weber,1610612748,MIA,7,3,4,169.0,8,2,4,0.25,13,0.615,1,0.667,20.6,17,3,14,0.176,32,0.531,3,0.586,8.4,25,5,18,0.2,45,0.556,4,0.61,11.6,2015-16
55,201572,Brook Lopez,1610612751,BKN,73,21,52,2457.0,204,152,45,0.745,406,0.502,10,0.515,5.7,369,161,203,0.436,653,0.565,64,0.626,5.9,573,313,248,0.546,1059,0.541,74,0.582,5.8,2015-16
56,203998,Bruno Caboclo,1610612761,TOR,6,6,0,43.0,1,1,0,1.0,3,0.333,0,0.333,3.3,1,0,1,0.0,5,0.2,0,0.2,3.6,2,1,1,0.5,8,0.25,0,0.25,3.5,2015-16
57,203955,Bryce Cotton,1610612763,MEM,8,1,7,39.0,0,0,0,0.0,2,0.0,0,0.0,0.0,0,0,0,0.0,3,0.0,0,0.0,0.0,0,0,0,0.0,5,0.0,0,0.0,0.0,2015-16
58,1626214,Bryce Dejean-Jones,1610612740,NOP,14,8,6,279.0,8,3,5,0.375,22,0.364,1,0.381,10.2,40,11,29,0.275,65,0.615,7,0.69,6.7,48,14,34,0.292,87,0.552,8,0.608,7.3,2015-16
59,201228,C.J. Watson,1610612753,ORL,33,14,19,656.0,10,4,6,0.4,28,0.357,1,0.37,15.1,56,6,51,0.107,96,0.583,10,0.651,10.0,66,10,57,0.152,124,0.532,11,0.584,10.7,2015-16
60,203912,C.J. Wilcox,1610612746,LAC,23,15,8,167.0,1,0,1,0.0,6,0.167,0,0.167,23.6,11,3,8,0.273,26,0.423,4,0.5,9.8,12,3,9,0.25,32,0.375,4,0.429,11.0,2015-16
61,203468,CJ McCollum,1610612757,POR,80,44,36,2780.0,47,13,34,0.277,232,0.203,11,0.213,14.3,212,34,178,0.16,417,0.508,38,0.559,9.3,259,47,212,0.181,649,0.399,49,0.432,10.2,2015-16
62,101139,CJ Miles,1610612754,IND,64,34,30,1464.0,25,17,9,0.68,91,0.275,2,0.281,8.4,150,51,103,0.34,300,0.5,30,0.556,6.2,175,68,112,0.389,391,0.448,32,0.487,6.5,2015-16
63,203946,Cameron Bairstow,1610612765,DET,18,4,14,103.0,4,3,1,0.75,25,0.16,0,0.16,2.4,24,6,18,0.25,40,0.6,3,0.649,6.3,28,9,19,0.321,65,0.431,3,0.452,5.7,2015-16
64,1626166,Cameron Payne,1610612760,OKC,57,44,13,698.0,9,3,6,0.333,52,0.173,1,0.176,13.2,76,6,72,0.079,130,0.585,7,0.618,6.8,85,9,78,0.106,182,0.467,8,0.489,7.4,2015-16
65,201171,Carl Landry,1610612755,PHI,36,5,31,569.0,49,35,14,0.714,102,0.48,2,0.49,5.4,97,23,73,0.237,168,0.577,21,0.66,5.1,146,58,87,0.397,270,0.541,23,0.591,5.2,2015-16
66,2546,Carmelo Anthony,1610612752,NYK,72,32,40,2530.0,98,66,26,0.673,288,0.34,8,0.35,6.9,458,89,367,0.194,646,0.709,35,0.75,6.3,556,155,393,0.279,934,0.595,43,0.624,6.4,2015-16
67,2406,Caron Butler,1610612758,SAC,16,2,14,168.0,5,2,3,0.4,9,0.556,0,0.556,17.4,17,3,14,0.176,40,0.425,4,0.472,7.2,22,5,17,0.227,49,0.449,4,0.489,9.5,2015-16
68,202718,Chandler Parsons,1610612742,DAL,61,29,32,1799.0,29,6,24,0.207,134,0.216,12,0.238,15.7,256,60,197,0.234,401,0.638,25,0.681,6.5,285,66,221,0.232,535,0.533,37,0.572,7.5,2015-16
69,101112,Channing Frye,1610612739,CLE,69,35,34,1177.0,35,19,15,0.543,65,0.538,1,0.547,9.7,193,58,131,0.301,350,0.551,25,0.594,4.4,228,77,146,0.338,415,0.549,26,0.586,5.2,2015-16
70,101111,Charlie Villanueva,1610612742,DAL,62,29,33,665.0,24,17,8,0.708,72,0.333,4,0.353,8.3,128,29,98,0.227,195,0.656,11,0.696,5.1,152,46,106,0.303,267,0.569,15,0.603,5.6,2015-16
71,201978,Chase Budinger,1610612756,PHX,66,29,37,930.0,43,16,25,0.372,91,0.473,1,0.478,8.4,107,25,83,0.234,189,0.566,19,0.629,7.3,150,41,108,0.273,280,0.536,20,0.577,7.6,2015-16
72,2365,Chris Andersen,1610612763,MEM,27,11,16,403.0,36,29,7,0.806,77,0.468,2,0.48,4.9,62,26,38,0.419,109,0.569,9,0.62,4.1,98,55,45,0.561,186,0.527,11,0.56,4.4,2015-16
73,2547,Chris Bosh,1610612748,MIA,53,29,24,1778.0,48,31,17,0.646,120,0.4,2,0.407,9.1,342,104,235,0.304,544,0.629,38,0.676,5.3,390,135,252,0.346,664,0.587,40,0.625,5.8,2015-16
74,203142,Chris Copeland,1610612749,MIL,24,10,14,156.0,1,1,0,1.0,13,0.077,1,0.083,2.5,9,2,7,0.222,34,0.265,3,0.29,4.9,10,3,7,0.3,47,0.213,4,0.233,4.6,2015-16
75,203187,Chris Johnson,1610612762,UTA,70,38,32,857.0,27,10,16,0.37,66,0.409,4,0.435,12.8,105,25,81,0.238,186,0.565,16,0.618,7.2,132,35,97,0.265,252,0.524,20,0.569,8.3,2015-16
76,2549,Chris Kaman,1610612757,POR,16,11,5,112.0,7,4,3,0.571,15,0.467,0,0.467,7.4,17,8,9,0.471,39,0.436,3,0.472,3.9,24,12,12,0.5,54,0.444,3,0.471,4.9,2015-16
77,1626191,Chris McCullough,1610612751,BKN,24,7,17,362.0,25,11,13,0.44,62,0.403,0,0.403,7.9,43,13,31,0.302,94,0.457,11,0.518,5.8,68,24,44,0.353,156,0.436,11,0.469,6.5,2015-16
78,101108,Chris Paul,1610612746,LAC,74,50,24,2420.0,39,12,26,0.308,170,0.229,13,0.248,14.4,271,57,217,0.21,527,0.514,31,0.546,9.5,310,69,243,0.223,697,0.445,44,0.475,10.1,2015-16
79,1626174,Christian Wood,1610612755,PHI,17,0,17,145.0,13,5,7,0.385,27,0.481,0,0.481,4.8,25,15,11,0.6,51,0.49,7,0.568,5.4,38,20,18,0.526,78,0.487,7,0.535,5.2,2015-16
80,101236,Chuck Hayes,1610612746,LAC,2,1,1,24.0,0,0,0,0.0,1,0.0,0,0.0,0.0,8,4,4,0.5,13,0.615,0,0.615,3.0,8,4,4,0.5,14,0.571,0,0.571,3.0,2015-16
81,203921,Cleanthony Early,1610612752,NYK,17,6,11,154.0,4,2,2,0.5,21,0.19,0,0.19,8.5,22,3,19,0.136,44,0.5,4,0.55,6.1,26,5,21,0.192,65,0.4,4,0.426,6.5,2015-16
82,1626146,Cliff Alexander,1610612757,POR,8,3,5,36.0,2,2,0,1.0,7,0.286,0,0.286,3.1,4,1,3,0.25,9,0.444,2,0.571,7.0,6,3,3,0.5,16,0.375,2,0.429,5.7,2015-16
83,203991,Clint Capela,1610612745,HOU,77,39,38,1471.0,194,157,36,0.809,410,0.473,10,0.485,5.0,300,131,170,0.437,536,0.56,33,0.596,4.5,494,288,206,0.583,946,0.522,43,0.547,4.7,2015-16
84,203469,Cody Zeller,1610612766,CHA,73,42,31,1774.0,138,93,45,0.674,384,0.359,10,0.369,5.7,317,118,195,0.372,594,0.534,60,0.594,4.9,455,211,240,0.464,978,0.465,70,0.501,5.2,2015-16
85,202332,Cole Aldrich,1610612746,LAC,60,41,19,800.0,86,53,32,0.616,189,0.455,2,0.46,6.1,202,74,123,0.366,326,0.62,29,0.68,4.2,288,127,155,0.441,515,0.559,31,0.595,4.8,2015-16
86,201147,Corey Brewer,1610612745,HOU,82,41,41,1669.0,42,14,26,0.333,162,0.259,5,0.268,11.8,157,36,121,0.229,305,0.515,31,0.573,8.6,199,50,147,0.251,467,0.426,36,0.462,9.2,2015-16
87,203928,Cory Jefferson,1610612756,PHX,8,2,6,50.0,6,5,1,0.833,17,0.353,0,0.353,16.1,10,6,3,0.6,17,0.588,3,0.714,4.2,16,11,4,0.688,34,0.471,3,0.516,8.9,2015-16
88,202709,Cory Joseph,1610612761,TOR,79,53,26,2011.0,38,14,24,0.368,203,0.187,8,0.195,11.2,169,37,136,0.219,387,0.437,24,0.466,8.1,207,51,160,0.246,590,0.351,32,0.371,8.6,2015-16
89,1626262,Coty Clarke,1610612738,BOS,3,0,3,6.0,0,0,0,0.0,0,0.0,0,0.0,0.0,1,1,0,1.0,2,0.5,0,0.5,5.9,1,1,0,1.0,2,0.5,0,0.5,5.9,2015-16
90,201584,Courtney Lee,1610612766,CHA,79,49,30,2334.0,29,8,20,0.276,106,0.274,5,0.287,16.5,176,27,148,0.153,285,0.618,15,0.652,8.9,205,35,168,0.171,391,0.524,20,0.553,10.0,2015-16
91,1626245,Cristiano Felicio,1610612741,CHI,31,14,17,321.0,30,16,14,0.533,95,0.316,0,0.316,6.2,72,27,45,0.375,135,0.533,11,0.581,4.2,102,43,59,0.422,230,0.443,11,0.466,4.8,2015-16
92,1626156,D'Angelo Russell,1610612747,LAL,80,17,63,2259.0,47,24,24,0.511,227,0.207,8,0.215,12.6,227,26,201,0.115,415,0.547,32,0.593,8.4,274,50,225,0.182,642,0.427,40,0.455,9.2,2015-16
93,201571,D.J. Augustin,1610612743,DEN,62,35,27,1178.0,8,1,7,0.125,80,0.1,5,0.107,15.5,87,6,86,0.069,165,0.527,10,0.561,10.4,95,7,93,0.074,245,0.388,15,0.413,10.8,2015-16
94,2563,Dahntay Jones,1610612739,CLE,1,0,1,42.0,1,0,1,0.0,9,0.111,0,0.111,6.3,4,0,4,0.0,10,0.4,1,0.444,9.0,5,0,5,0.0,19,0.263,1,0.278,8.5,2015-16
95,203081,Damian Lillard,1610612757,POR,75,40,35,2676.0,45,14,34,0.311,236,0.191,13,0.202,14.6,257,38,225,0.148,478,0.538,39,0.585,8.7,302,52,259,0.172,714,0.423,52,0.456,9.6,2015-16
96,203996,Damien Inglis,1610612749,MIL,20,5,15,156.0,2,1,1,0.5,18,0.111,0,0.111,12.2,29,9,20,0.31,45,0.644,1,0.659,5.7,31,10,21,0.323,63,0.492,1,0.5,6.1,2015-16
97,204014,Damjan Rudez,1610612750,MIN,33,9,24,277.0,5,1,4,0.2,15,0.333,0,0.333,11.7,15,5,10,0.333,40,0.375,2,0.395,8.4,20,6,14,0.3,55,0.364,2,0.377,9.2,2015-16
98,201568,Danilo Gallinari,1610612743,DEN,53,22,31,1839.0,52,33,19,0.635,173,0.301,4,0.308,7.3,229,55,174,0.24,374,0.612,36,0.678,6.6,281,88,193,0.313,547,0.514,40,0.554,6.7,2015-16
99,201980,Danny Green,1610612759,SAS,79,65,14,2061.0,48,23,25,0.479,129,0.372,4,0.384,10.8,255,59,194,0.231,528,0.483,45,0.528,5.8,303,82,219,0.271,657,0.461,49,0.498,6.6,2015-16
100,201967,Dante Cunningham,1610612740,NOP,80,28,52,1971.0,57,25,30,0.439,168,0.339,6,0.352,10.9,179,29,149,0.162,325,0.551,22,0.591,7.0,236,54,179,0.229,493,0.479,28,0.508,7.9,2015-16
101,201589,Darrell Arthur,1610612743,DEN,70,26,44,1516.0,86,39,43,0.453,187,0.46,3,0.467,8.3,207,71,137,0.343,394,0.525,47,0.597,5.5,293,110,180,0.375,581,0.504,50,0.552,6.3,2015-16
102,201954,Darren Collison,1610612758,SAC,73,29,44,2192.0,28,11,16,0.393,175,0.16,7,0.167,12.1,140,13,124,0.093,269,0.52,23,0.569,11.7,168,24,140,0.143,444,0.378,30,0.406,11.7,2015-16
103,1626199,Darrun Hilliard,1610612765,DET,38,17,21,383.0,5,0,4,0.0,24,0.208,0,0.208,22.1,40,8,32,0.2,66,0.606,3,0.635,7.7,45,8,36,0.178,90,0.5,3,0.517,9.0,2015-16
104,101135,David Lee,1610612742,DAL,54,26,28,888.0,100,69,27,0.69,227,0.441,5,0.45,6.3,202,60,139,0.297,352,0.574,28,0.623,4.3,302,129,166,0.427,579,0.522,33,0.553,5.0,2015-16
105,2561,David West,1610612759,SAS,78,63,15,1404.0,72,51,21,0.708,189,0.381,6,0.393,6.9,237,81,155,0.342,427,0.555,41,0.614,5.4,309,132,176,0.427,616,0.502,47,0.543,5.7,2015-16
106,201599,DeAndre Jordan,1610612746,LAC,77,51,26,2598.0,267,184,77,0.689,511,0.523,13,0.536,5.6,792,232,553,0.293,1147,0.69,72,0.737,4.6,1059,416,630,0.393,1658,0.639,85,0.673,4.9,2015-16
107,201971,DeJuan Blair,1610612764,WAS,29,12,17,218.0,20,15,4,0.75,50,0.4,1,0.408,6.3,37,19,18,0.514,54,0.685,6,0.771,4.4,57,34,22,0.596,104,0.548,7,0.588,5.0,2015-16
108,201942,DeMar DeRozan,1610612761,TOR,77,52,25,2764.0,62,35,29,0.565,244,0.254,11,0.266,10.7,276,58,218,0.21,473,0.584,33,0.627,7.9,338,93,247,0.275,717,0.471,44,0.502,8.4,2015-16
109,202326,DeMarcus Cousins,1610612758,SAC,64,29,35,2221.0,154,110,32,0.714,402,0.383,12,0.395,5.0,586,230,354,0.392,871,0.673,47,0.711,4.5,740,340,386,0.459,1273,0.581,59,0.61,4.6,2015-16
110,201960,DeMarre Carroll,1610612761,TOR,26,16,10,786.0,31,18,12,0.581,100,0.31,4,0.323,8.9,91,19,71,0.209,162,0.562,15,0.619,7.9,122,37,83,0.303,262,0.466,19,0.502,8.1,2015-16
111,1626153,Delon Wright,1610612761,TOR,27,19,8,229.0,8,4,4,0.5,36,0.222,0,0.222,12.5,29,5,24,0.172,54,0.537,5,0.592,8.2,37,9,28,0.243,90,0.411,5,0.435,9.1,2015-16
112,203471,Dennis Schroder,1610612737,ATL,80,47,33,1621.0,25,10,15,0.4,136,0.184,6,0.192,13.0,179,22,160,0.123,343,0.522,24,0.561,8.5,204,32,175,0.157,479,0.426,30,0.454,9.1,2015-16
113,101114,Deron Williams,1610612742,DAL,65,31,34,2106.0,19,5,15,0.263,141,0.135,9,0.144,15.1,171,30,143,0.175,358,0.478,28,0.518,9.3,190,35,158,0.184,499,0.381,37,0.411,9.9,2015-16
114,202324,Derrick Favors,1610612762,UTA,62,30,32,1983.0,169,124,45,0.734,390,0.433,8,0.442,6.3,334,139,191,0.416,570,0.586,49,0.641,4.6,503,263,236,0.523,960,0.524,57,0.557,5.2,2015-16
115,201565,Derrick Rose,1610612741,CHI,66,32,34,2097.0,46,26,21,0.565,269,0.171,10,0.178,9.5,179,28,156,0.156,343,0.522,20,0.554,10.4,225,54,177,0.24,612,0.368,30,0.387,10.2,2015-16
116,202682,Derrick Williams,1610612752,NYK,80,32,48,1435.0,47,23,22,0.489,142,0.331,3,0.338,9.4,249,49,201,0.197,359,0.694,19,0.732,5.4,296,72,223,0.243,501,0.591,22,0.618,6.0,2015-16
117,1626164,Devin Booker,1610612756,PHX,76,20,56,2108.0,27,11,17,0.407,155,0.174,8,0.184,13.1,160,28,132,0.175,358,0.447,32,0.491,8.2,187,39,149,0.209,513,0.365,40,0.395,8.9,2015-16
118,2734,Devin Harris,1610612742,DAL,64,35,29,1280.0,18,3,15,0.167,73,0.247,0,0.247,14.4,120,26,90,0.217,233,0.515,26,0.58,7.6,138,29,105,0.21,306,0.451,26,0.493,8.5,2015-16
119,203906,Devyn Marble,1610612753,ORL,28,12,16,249.0,6,1,3,0.167,16,0.375,0,0.375,16.7,32,4,28,0.125,49,0.653,5,0.727,6.9,38,5,31,0.132,65,0.585,5,0.633,8.0,2015-16
120,203473,Dewayne Dedmon,1610612753,ORL,58,21,37,705.0,67,44,19,0.657,139,0.482,5,0.5,6.4,161,59,103,0.366,241,0.668,16,0.716,4.4,228,103,122,0.452,380,0.6,21,0.635,5.0,2015-16
121,203079,Dion Waiters,1610612760,OKC,78,53,25,2152.0,36,9,25,0.25,128,0.281,5,0.293,13.8,166,29,136,0.175,296,0.561,38,0.643,8.0,202,38,161,0.188,424,0.476,43,0.53,9.0,2015-16
122,1717,Dirk Nowitzki,1610612742,DAL,75,38,37,2364.0,52,36,16,0.692,130,0.4,11,0.437,10.8,437,147,290,0.336,720,0.607,64,0.666,4.6,489,183,306,0.374,850,0.575,75,0.631,5.3,2015-16
123,202388,Donald Sloan,1610612751,BKN,61,13,48,1318.0,17,4,13,0.235,77,0.221,6,0.239,15.8,156,18,137,0.115,251,0.622,14,0.658,8.3,173,22,150,0.127,328,0.527,20,0.562,9.0,2015-16
124,202700,Donatas Motiejunas,1610612745,HOU,37,19,18,547.0,37,24,13,0.649,68,0.544,1,0.552,8.2,72,18,54,0.25,156,0.462,12,0.5,5.2,109,42,67,0.385,224,0.487,13,0.517,6.2,2015-16
125,203926,Doug McDermott,1610612741,CHI,81,41,40,1861.0,37,17,19,0.459,123,0.301,8,0.322,12.8,158,32,124,0.203,316,0.5,37,0.566,7.2,195,49,143,0.251,439,0.444,45,0.495,8.2,2015-16
126,203110,Draymond Green,1610612744,GSW,81,73,8,2808.0,134,95,35,0.709,326,0.411,8,0.421,6.3,635,239,392,0.376,993,0.639,58,0.679,4.8,769,334,427,0.434,1319,0.583,66,0.614,5.0,2015-16
127,2400,Drew Gooden,1610612764,WAS,30,18,12,305.0,28,19,6,0.679,48,0.583,2,0.609,6.2,57,19,38,0.333,97,0.588,6,0.626,4.9,85,38,44,0.447,145,0.586,8,0.62,5.3,2015-16
128,1626251,Duje Dukan,1610612758,SAC,1,0,1,24.0,2,1,1,0.5,4,0.5,0,0.5,7.5,2,0,2,0.0,5,0.4,1,0.5,7.0,4,1,3,0.25,9,0.444,1,0.5,7.3,2015-16
129,2730,Dwight Howard,1610612745,HOU,71,34,37,2280.0,238,172,61,0.723,554,0.43,15,0.442,4.6,597,214,374,0.358,916,0.652,56,0.694,3.9,835,386,435,0.462,1470,0.568,71,0.597,4.1,2015-16
130,203939,Dwight Powell,1610612742,DAL,69,35,34,992.0,84,54,30,0.643,218,0.385,8,0.4,6.3,189,48,138,0.254,293,0.645,16,0.682,4.6,273,102,168,0.374,511,0.534,24,0.561,5.2,2015-16
131,2548,Dwyane Wade,1610612748,MIA,74,43,31,2258.0,82,47,33,0.573,243,0.337,8,0.349,7.5,220,49,172,0.223,390,0.564,30,0.611,8.3,302,96,205,0.318,633,0.477,38,0.508,8.1,2015-16
132,202734,E'Twaun Moore,1610612741,CHI,59,29,30,1263.0,19,9,10,0.474,72,0.264,2,0.271,12.0,114,26,89,0.228,215,0.53,27,0.606,9.6,133,35,99,0.263,287,0.463,29,0.516,9.9,2015-16
133,202334,Ed Davis,1610612757,POR,81,43,38,1684.0,224,150,66,0.67,513,0.437,15,0.45,5.6,375,143,236,0.381,660,0.568,68,0.633,4.5,599,293,302,0.489,1173,0.511,83,0.55,4.9,2015-16
134,204002,Edy Tavares,1610612737,ATL,11,7,4,73.0,7,3,4,0.429,18,0.389,0,0.389,3.8,14,6,8,0.429,24,0.583,5,0.737,4.2,21,9,12,0.429,42,0.5,5,0.568,4.1,2015-16
135,203901,Elfrid Payton,1610612753,ORL,72,32,40,2125.0,77,36,37,0.468,256,0.301,12,0.316,9.9,183,26,159,0.142,336,0.545,37,0.612,9.0,260,62,196,0.238,592,0.439,49,0.479,9.3,2015-16
136,202407,Elijah Millsap,1610612762,UTA,20,9,11,173.0,6,4,2,0.667,27,0.222,1,0.231,10.8,29,10,19,0.345,48,0.604,3,0.644,7.3,35,14,21,0.4,75,0.467,4,0.493,7.9,2015-16
137,202343,Elliot Williams,1610612766,CHA,5,4,1,45.0,1,0,1,0.0,2,0.5,0,0.5,17.6,3,1,2,0.333,3,1.0,0,1.0,5.2,4,1,3,0.25,5,0.8,0,0.8,8.3,2015-16
138,1882,Elton Brand,1610612755,PHI,17,2,15,225.0,9,6,3,0.667,23,0.391,0,0.391,7.8,54,17,36,0.315,82,0.659,3,0.684,6.3,63,23,39,0.365,105,0.6,3,0.618,6.5,2015-16
139,1626144,Emmanuel Mudiay,1610612743,DEN,68,29,39,2068.0,32,16,14,0.5,177,0.181,5,0.186,11.3,200,24,177,0.12,403,0.496,35,0.543,8.7,232,40,191,0.172,580,0.4,40,0.43,9.0,2015-16
140,202683,Enes Kanter,1610612760,OKC,82,55,27,1721.0,249,200,33,0.803,563,0.442,17,0.456,4.1,415,153,262,0.369,687,0.604,58,0.66,4.0,664,353,295,0.532,1250,0.531,75,0.565,4.0,2015-16
141,202339,Eric Bledsoe,1610612756,PHX,31,12,19,1059.0,18,7,12,0.389,100,0.18,4,0.188,11.8,107,20,85,0.187,196,0.546,20,0.608,9.0,125,27,97,0.216,296,0.422,24,0.46,9.3,2015-16
142,201569,Eric Gordon,1610612740,NOP,45,14,31,1481.0,10,1,9,0.1,65,0.154,0,0.154,18.3,89,11,79,0.124,171,0.52,11,0.556,8.8,99,12,88,0.121,236,0.419,11,0.44,9.7,2015-16
143,203961,Eric Moreland,1610612758,SAC,7,1,6,43.0,3,2,1,0.667,17,0.176,0,0.176,6.9,6,5,1,0.833,13,0.462,3,0.6,4.3,9,7,2,0.778,30,0.3,3,0.333,5.2,2015-16
144,203475,Erick Green,1610612743,DEN,9,6,3,42.0,3,0,3,0.0,4,0.75,0,0.75,21.8,3,0,3,0.0,7,0.429,1,0.5,5.7,6,0,6,0.0,11,0.545,1,0.6,13.7,2015-16
145,101141,Ersan Ilyasova,1610612753,ORL,74,35,39,1880.0,144,97,40,0.674,318,0.453,9,0.466,5.8,259,89,167,0.344,450,0.576,55,0.656,5.7,403,186,207,0.462,768,0.525,64,0.572,5.7,2015-16
146,203095,Evan Fournier,1610612753,ORL,78,33,45,2532.0,32,10,22,0.313,209,0.153,2,0.155,11.8,190,37,153,0.195,362,0.525,27,0.567,8.7,222,47,175,0.212,571,0.389,29,0.41,9.2,2015-16
147,202323,Evan Turner,1610612738,BOS,80,46,34,2244.0,50,23,25,0.46,205,0.244,6,0.251,13.4,346,60,285,0.173,511,0.677,33,0.724,6.3,396,83,310,0.21,716,0.553,39,0.585,7.2,2015-16
148,203105,Festus Ezeli,1610612744,GSW,46,42,4,770.0,91,67,20,0.736,229,0.397,4,0.404,4.6,166,79,85,0.476,315,0.527,36,0.595,3.8,257,146,105,0.568,544,0.472,40,0.51,4.1,2015-16
149,1626163,Frank Kaminsky,1610612766,CHA,81,47,34,1708.0,69,41,27,0.594,211,0.327,9,0.342,8.0,266,87,182,0.327,503,0.529,39,0.573,5.3,335,128,209,0.382,714,0.469,48,0.503,5.9,2015-16
150,202066,Garrett Temple,1610612764,WAS,80,40,40,1951.0,36,19,18,0.528,145,0.248,6,0.259,10.1,176,44,131,0.25,334,0.527,32,0.583,8.6,212,63,149,0.297,479,0.443,38,0.481,8.8,2015-16
151,203914,Gary Harris,1610612743,DEN,76,31,45,2439.0,54,22,33,0.407,179,0.302,9,0.318,11.7,166,20,146,0.12,294,0.565,26,0.619,10.4,220,42,179,0.191,473,0.465,35,0.502,10.8,2015-16
152,202390,Gary Neal,1610612764,WAS,40,18,22,807.0,11,4,6,0.364,39,0.282,2,0.297,13.1,72,7,67,0.097,148,0.486,12,0.529,7.6,83,11,73,0.133,187,0.444,14,0.48,8.2,2015-16
153,201588,George Hill,1610612754,IND,74,41,33,2524.0,58,34,24,0.586,178,0.326,6,0.337,10.4,240,33,205,0.138,459,0.523,33,0.563,8.2,298,67,229,0.225,637,0.468,39,0.498,8.7,2015-16
154,101123,Gerald Green,1610612748,MIA,69,40,29,1557.0,25,12,12,0.48,92,0.272,2,0.278,9.5,138,20,119,0.145,265,0.521,18,0.559,8.2,163,32,131,0.196,357,0.457,20,0.484,8.5,2015-16
155,201945,Gerald Henderson,1610612757,POR,72,39,33,1431.0,30,8,21,0.267,99,0.303,4,0.316,12.9,181,30,150,0.166,293,0.618,25,0.675,7.3,211,38,171,0.18,392,0.538,29,0.581,8.1,2015-16
156,203507,Giannis Antetokounmpo,1610612749,MIL,80,32,48,2823.0,113,75,34,0.664,360,0.314,15,0.328,6.9,499,154,339,0.309,800,0.624,47,0.663,5.9,612,229,373,0.374,1160,0.528,62,0.557,6.1,2015-16
157,203922,Glenn Robinson III,1610612754,IND,45,24,21,508.0,12,6,7,0.5,55,0.218,2,0.226,13.0,56,10,45,0.179,114,0.491,13,0.554,7.2,68,16,52,0.235,169,0.402,15,0.442,8.3,2015-16
158,201609,Goran Dragic,1610612748,MIA,72,44,28,2363.0,54,26,29,0.481,212,0.255,5,0.261,10.1,223,24,202,0.108,411,0.543,36,0.595,10.0,277,50,231,0.181,623,0.445,41,0.476,10.1,2015-16
159,202330,Gordon Hayward,1610612762,UTA,80,38,42,2893.0,61,28,34,0.459,237,0.257,11,0.27,12.1,336,55,279,0.164,539,0.623,45,0.68,8.3,397,83,313,0.209,776,0.512,56,0.551,8.9,2015-16
160,203476,Gorgui Dieng,1610612750,MIN,82,29,53,2220.0,157,98,57,0.624,393,0.399,6,0.406,7.1,428,142,280,0.332,700,0.611,61,0.67,5.4,585,240,337,0.41,1093,0.535,67,0.57,5.8,2015-16
161,202328,Greg Monroe,1610612749,MIL,79,32,47,2314.0,218,158,54,0.725,511,0.427,17,0.441,5.1,478,190,280,0.397,738,0.648,56,0.701,4.6,696,348,334,0.5,1249,0.557,73,0.592,4.7,2015-16
162,202962,Greg Smith,1610612750,MIN,18,8,10,192.0,12,7,6,0.583,36,0.333,1,0.343,8.1,30,7,22,0.233,47,0.638,3,0.682,3.7,42,14,28,0.333,83,0.506,4,0.532,5.1,2015-16
163,202349,Greivis Vasquez,1610612749,MIL,23,9,14,460.0,5,3,3,0.6,29,0.172,0,0.172,21.2,42,6,36,0.143,93,0.452,10,0.506,8.3,47,9,39,0.191,122,0.385,10,0.42,9.7,2015-16
164,203084,Harrison Barnes,1610612744,GSW,66,59,7,2042.0,77,39,35,0.506,206,0.374,9,0.391,9.0,248,66,182,0.266,489,0.507,58,0.575,6.8,325,105,217,0.323,695,0.468,67,0.518,7.3,2015-16
165,202355,Hassan Whiteside,1610612748,MIA,73,42,31,2125.0,238,186,44,0.782,530,0.449,8,0.456,4.2,627,253,369,0.404,955,0.657,53,0.695,4.0,865,439,413,0.508,1485,0.582,61,0.607,4.1,2015-16
166,203156,Henry Sims,1610612751,BKN,14,2,12,263.0,21,14,7,0.667,64,0.328,2,0.339,6.2,51,21,31,0.412,90,0.567,3,0.586,4.5,72,35,38,0.486,154,0.468,5,0.483,5.0,2015-16
167,203138,Hollis Thompson,1610612755,PHI,77,10,67,2154.0,54,25,25,0.463,153,0.353,9,0.375,9.7,218,49,168,0.225,394,0.553,28,0.596,6.9,272,74,193,0.272,547,0.497,37,0.533,7.4,2015-16
168,203546,Ian Clark,1610612744,GSW,66,59,7,578.0,13,7,7,0.538,48,0.271,2,0.283,13.6,55,11,46,0.2,109,0.505,12,0.567,9.1,68,18,53,0.265,157,0.433,14,0.476,10.0,2015-16
169,101133,Ian Mahinmi,1610612754,IND,71,41,30,1816.0,138,78,57,0.565,285,0.484,6,0.495,7.3,369,150,217,0.407,635,0.581,71,0.654,5.2,507,228,274,0.45,920,0.551,77,0.601,5.8,2015-16
170,202697,Iman Shumpert,1610612739,CLE,54,39,15,1316.0,32,18,14,0.563,93,0.344,7,0.372,11.7,171,29,142,0.17,272,0.629,14,0.663,6.6,203,47,156,0.232,365,0.556,21,0.59,7.4,2015-16
171,203477,Isaiah Canaan,1610612755,PHI,77,10,67,1966.0,20,7,13,0.35,103,0.194,4,0.202,12.4,154,18,135,0.117,305,0.505,24,0.548,9.3,174,25,148,0.144,408,0.426,28,0.458,9.7,2015-16
172,202738,Isaiah Thomas,1610612738,BOS,81,47,34,2610.0,46,17,29,0.37,279,0.165,13,0.173,12.5,191,21,171,0.11,376,0.508,29,0.55,10.8,237,38,200,0.16,655,0.362,42,0.387,11.2,2015-16
173,202397,Ish Smith,1610612755,PHI,77,16,61,2239.0,43,13,30,0.302,192,0.224,5,0.23,13.0,262,27,238,0.103,519,0.505,51,0.56,8.3,305,40,268,0.131,711,0.429,56,0.466,8.9,2015-16
174,200826,J.J. Barea,1610612742,DAL,74,38,36,1667.0,26,9,16,0.346,141,0.184,3,0.188,13.2,126,13,114,0.103,240,0.525,17,0.565,10.0,152,22,130,0.145,381,0.399,20,0.421,10.5,2015-16
175,201581,JJ Hickson,1610612764,WAS,35,17,18,437.0,39,27,13,0.692,92,0.424,3,0.438,6.1,93,32,60,0.344,150,0.62,14,0.684,4.2,132,59,73,0.447,242,0.545,17,0.587,4.8,2015-16
176,1626266,JJ O'Brien,1610612762,UTA,2,2,0,6.0,0,0,0,0.0,0,0.0,0,0.0,0.0,1,0,1,0.0,1,1.0,0,1.0,4.6,1,0,1,0.0,1,1.0,0,1.0,4.6,2015-16
177,200755,JJ Redick,1610612746,LAC,75,50,25,2097.0,10,1,9,0.1,76,0.132,2,0.135,19.7,129,12,118,0.093,284,0.454,27,0.502,9.7,139,13,127,0.094,360,0.386,29,0.42,10.4,2015-16
178,2747,JR Smith,1610612739,CLE,77,53,24,2362.0,43,10,30,0.233,111,0.387,6,0.41,16.9,174,24,152,0.138,297,0.586,30,0.652,8.2,217,34,182,0.157,408,0.532,36,0.583,9.9,2015-16
179,203960,JaKarr Sampson,1610612743,DEN,73,18,55,1160.0,46,31,15,0.674,137,0.336,4,0.346,5.8,144,36,110,0.25,271,0.531,23,0.581,6.3,190,67,125,0.353,408,0.466,27,0.499,6.2,2015-16
180,203210,JaMychal Green,1610612763,MEM,78,39,39,1446.0,139,104,29,0.748,294,0.473,13,0.495,5.9,234,82,150,0.35,380,0.616,30,0.669,4.7,373,186,179,0.499,674,0.553,43,0.591,5.1,2015-16
181,201580,JaVale McGee,1610612742,DAL,34,15,19,370.0,53,35,16,0.66,101,0.525,2,0.535,5.0,80,31,47,0.388,137,0.584,9,0.625,4.1,133,66,63,0.496,238,0.559,11,0.586,4.5,2015-16
182,203953,Jabari Parker,1610612749,MIL,76,32,44,2408.0,123,61,59,0.496,340,0.362,10,0.373,7.8,272,69,201,0.254,527,0.516,33,0.551,6.4,395,130,260,0.329,867,0.456,43,0.479,6.9,2015-16
183,203109,Jae Crowder,1610612738,BOS,72,42,30,2278.0,70,29,39,0.414,207,0.338,11,0.357,11.2,300,60,238,0.2,451,0.665,33,0.718,7.2,370,89,277,0.241,658,0.562,44,0.603,8.0,2015-16
184,1626143,Jahlil Okafor,1610612755,PHI,53,6,47,1591.0,122,82,38,0.672,313,0.39,6,0.397,6.1,251,102,148,0.406,471,0.533,50,0.596,4.7,373,184,186,0.493,784,0.476,56,0.512,5.1,2015-16
185,2037,Jamal Crawford,1610612746,LAC,79,51,28,2126.0,20,6,14,0.3,95,0.211,10,0.235,9.8,125,14,112,0.112,267,0.468,16,0.498,10.3,145,20,126,0.138,362,0.401,26,0.432,10.3,2015-16
186,2749,Jameer Nelson,1610612743,DEN,39,12,27,1036.0,19,2,17,0.105,62,0.306,0,0.306,18.4,96,15,82,0.156,193,0.497,19,0.552,8.6,115,17,99,0.148,255,0.451,19,0.487,10.2,2015-16
187,202341,James Anderson,1610612758,SAC,50,19,31,717.0,13,6,7,0.462,41,0.317,0,0.317,10.1,72,19,53,0.264,129,0.558,8,0.595,7.4,85,25,60,0.294,170,0.5,8,0.525,7.8,2015-16
188,203516,James Ennis III,1610612740,NOP,22,11,11,329.0,21,10,10,0.476,44,0.477,1,0.488,8.0,21,8,13,0.381,45,0.467,4,0.512,6.6,42,18,23,0.429,89,0.472,5,0.5,7.3,2015-16
189,201935,James Harden,1610612745,HOU,82,41,41,3125.0,63,32,35,0.508,265,0.238,9,0.246,10.3,438,100,338,0.228,652,0.672,42,0.718,7.6,501,132,373,0.263,917,0.546,51,0.579,7.9,2015-16
190,201949,James Johnson,1610612761,TOR,56,34,22,908.0,28,10,17,0.357,96,0.292,3,0.301,8.2,98,19,79,0.194,193,0.508,18,0.56,6.1,126,29,96,0.23,289,0.436,21,0.47,6.6,2015-16
191,2592,James Jones,1610612739,CLE,48,33,15,463.0,8,2,5,0.25,23,0.348,0,0.348,19.6,42,8,34,0.19,85,0.494,10,0.56,7.6,50,10,39,0.2,108,0.463,10,0.51,9.3,2015-16
192,203949,James Michael McAdoo,1610612744,GSW,41,37,4,262.0,30,19,8,0.633,79,0.38,0,0.38,6.7,28,10,18,0.357,71,0.394,11,0.467,6.6,58,29,26,0.5,150,0.387,11,0.417,6.7,2015-16
193,203923,James Young,1610612738,BOS,28,11,17,196.0,4,1,3,0.25,13,0.308,0,0.308,15.8,22,7,16,0.318,33,0.667,2,0.71,6.2,26,8,19,0.308,46,0.565,2,0.591,7.6,2015-16
194,203099,Jared Cunningham,1610612739,CLE,44,31,13,410.0,3,0,3,0.0,36,0.083,3,0.091,15.5,35,9,26,0.257,61,0.574,3,0.603,11.5,38,9,29,0.237,97,0.392,6,0.418,11.8,2015-16
195,201162,Jared Dudley,1610612764,WAS,81,40,41,2098.0,54,26,25,0.481,183,0.295,9,0.31,10.7,232,67,167,0.289,591,0.393,70,0.445,7.6,286,93,192,0.325,774,0.37,79,0.412,8.2,2015-16
196,203096,Jared Sullinger,1610612738,BOS,80,46,34,1900.0,194,131,61,0.675,400,0.485,8,0.495,5.7,476,212,261,0.445,755,0.63,43,0.669,4.6,670,343,322,0.512,1155,0.58,51,0.607,4.9,2015-16
197,204067,Jarell Eddie,1610612764,WAS,26,13,13,147.0,2,1,1,0.5,5,0.4,0,0.4,27.1,21,2,19,0.095,29,0.724,2,0.778,8.5,23,3,20,0.13,34,0.676,2,0.719,10.1,2015-16
198,1626185,Jarell Martin,1610612763,MEM,27,10,17,380.0,39,23,17,0.59,97,0.402,2,0.411,6.1,47,13,36,0.277,101,0.465,11,0.522,5.5,86,36,53,0.419,198,0.434,13,0.465,5.9,2015-16
199,203950,Jarnell Stokes,1610612763,MEM,7,1,6,19.0,1,1,0,1.0,6,0.167,0,0.167,2.9,3,2,1,0.667,4,0.75,0,0.75,2.5,4,3,1,0.75,10,0.4,0,0.4,2.6,2015-16
200,101127,Jarrett Jack,1610612751,BKN,32,10,22,1027.0,9,4,6,0.444,48,0.188,4,0.205,20.2,127,13,117,0.102,214,0.593,24,0.668,8.5,136,17,123,0.125,262,0.519,28,0.581,9.3,2015-16
201,201160,Jason Smith,1610612753,ORL,75,33,42,1144.0,52,30,23,0.577,145,0.359,5,0.371,8.2,162,68,94,0.42,310,0.523,28,0.574,4.9,214,98,117,0.458,455,0.47,33,0.507,5.7,2015-16
202,1891,Jason Terry,1610612745,HOU,72,37,35,1258.0,14,2,12,0.143,60,0.233,2,0.241,14.3,65,8,56,0.123,144,0.451,9,0.481,11.1,79,10,68,0.127,204,0.387,11,0.409,11.6,2015-16
203,201574,Jason Thompson,1610612761,TOR,47,38,9,471.0,32,16,15,0.5,82,0.39,2,0.4,6.8,102,26,75,0.255,168,0.607,15,0.667,4.8,134,42,90,0.313,250,0.536,17,0.575,5.2,2015-16
204,201965,Jeff Ayres,1610612746,LAC,17,11,6,107.0,4,4,0,1.0,18,0.222,1,0.235,3.8,18,5,13,0.278,31,0.581,1,0.6,4.3,22,9,13,0.409,49,0.449,2,0.468,4.2,2015-16
205,201145,Jeff Green,1610612746,LAC,80,48,32,2253.0,74,42,29,0.568,217,0.341,8,0.354,9.0,258,74,182,0.287,472,0.547,37,0.593,6.5,332,116,211,0.349,689,0.482,45,0.516,7.0,2015-16
206,201952,Jeff Teague,1610612737,ATL,79,47,32,2255.0,33,16,20,0.485,187,0.176,10,0.186,12.5,181,14,169,0.077,346,0.523,29,0.571,10.3,214,30,189,0.14,533,0.402,39,0.433,10.8,2015-16
207,203481,Jeff Withey,1610612762,UTA,51,25,26,658.0,56,36,19,0.643,152,0.368,8,0.389,5.9,117,45,70,0.385,231,0.506,25,0.568,4.5,173,81,89,0.468,383,0.452,33,0.494,5.0,2015-16
208,203924,Jerami Grant,1610612755,PHI,77,9,68,2066.0,99,61,39,0.616,259,0.382,6,0.391,6.4,262,81,180,0.309,535,0.49,49,0.539,5.6,361,142,219,0.393,794,0.455,55,0.488,5.8,2015-16
209,202379,Jeremy Evans,1610612742,DAL,30,16,14,251.0,11,7,4,0.636,27,0.407,1,0.423,12.0,43,14,29,0.326,66,0.652,6,0.717,4.9,54,21,33,0.389,93,0.581,7,0.628,6.4,2015-16
210,203087,Jeremy Lamb,1610612766,CHA,66,40,26,1227.0,44,23,23,0.523,110,0.4,2,0.407,7.8,208,34,175,0.163,358,0.581,34,0.642,5.6,252,57,198,0.226,468,0.538,36,0.583,6.1,2015-16
211,202391,Jeremy Lin,1610612766,CHA,78,47,31,2048.0,42,13,25,0.31,169,0.249,7,0.259,14.9,211,44,167,0.209,448,0.471,41,0.518,8.3,253,57,192,0.225,617,0.41,48,0.445,9.3,2015-16
212,1626170,Jerian Grant,1610612752,NYK,76,29,47,1265.0,23,6,16,0.261,114,0.202,4,0.209,12.0,120,21,100,0.175,254,0.472,33,0.543,8.3,143,27,116,0.189,368,0.389,37,0.432,8.8,2015-16
213,201573,Jerryd Bayless,1610612749,MIL,52,21,31,1505.0,21,4,17,0.19,71,0.296,4,0.313,19.1,120,17,102,0.142,236,0.508,20,0.556,8.8,141,21,119,0.149,307,0.459,24,0.498,10.3,2015-16
214,202690,Jimmer Fredette,1610612759,SAS,6,1,5,18.0,0,0,0,0.0,0,0.0,0,0.0,0.0,0,0,0,0.0,2,0.0,1,0.0,0.0,0,0,0,0.0,2,0.0,1,0.0,0.0,2015-16
215,202710,Jimmy Butler,1610612741,CHI,67,37,30,2474.0,79,39,35,0.494,251,0.315,6,0.322,8.8,279,60,222,0.215,549,0.508,48,0.557,8.4,358,99,257,0.277,800,0.448,54,0.48,8.4,2015-16
216,201149,Joakim Noah,1610612741,CHI,29,15,14,635.0,87,66,20,0.759,194,0.448,5,0.46,4.4,168,77,93,0.458,273,0.615,17,0.656,4.1,255,143,113,0.561,467,0.546,22,0.573,4.2,2015-16
217,201975,Jodie Meeks,1610612765,DET,3,3,0,43.0,1,0,1,0.0,3,0.333,1,0.5,7.8,4,0,4,0.0,7,0.571,2,0.8,11.6,5,0,5,0.0,10,0.5,3,0.714,10.8,2015-16
218,203925,Joe Harris,1610612739,CLE,5,5,0,15.0,0,0,0,0.0,1,0.0,0,0.0,0.0,3,0,3,0.0,4,0.75,0,0.75,4.1,3,0,3,0.0,5,0.6,0,0.6,4.1,2015-16
219,204060,Joe Ingles,1610612762,UTA,81,40,41,1241.0,19,5,13,0.263,50,0.38,2,0.396,16.0,132,29,100,0.22,235,0.562,19,0.611,8.2,151,34,113,0.225,285,0.53,21,0.572,9.1,2015-16
220,2207,Joe Johnson,1610612748,MIA,81,31,50,2703.0,49,25,23,0.51,178,0.275,8,0.288,10.3,243,36,209,0.148,415,0.586,38,0.645,8.0,292,61,232,0.209,593,0.492,46,0.534,8.4,2015-16
221,1626202,Joe Young,1610612754,IND,41,19,22,384.0,6,0,6,0.0,27,0.222,0,0.222,18.2,44,5,39,0.114,76,0.579,4,0.611,9.1,50,5,45,0.1,103,0.485,4,0.505,10.2,2015-16
222,201202,Joel Anthony,1610612765,DET,19,12,7,96.0,8,5,1,0.625,21,0.381,2,0.421,8.0,13,4,9,0.308,33,0.394,5,0.464,4.9,21,9,10,0.429,54,0.389,7,0.447,5.9,2015-16
223,203530,Joffrey Lauvergne,1610612743,DEN,59,24,35,1041.0,77,47,26,0.61,212,0.363,4,0.37,6.5,213,66,144,0.31,337,0.632,22,0.676,4.3,290,113,170,0.39,549,0.528,26,0.554,4.9,2015-16
224,203089,John Henson,1610612749,MIL,57,22,35,960.0,87,58,28,0.667,186,0.468,5,0.481,4.9,134,69,64,0.515,274,0.489,24,0.536,4.6,221,127,92,0.575,460,0.48,29,0.513,4.7,2015-16
225,203098,John Jenkins,1610612756,PHX,43,18,25,480.0,8,3,5,0.375,29,0.276,2,0.296,13.5,49,8,41,0.163,89,0.551,11,0.628,8.4,57,11,46,0.193,118,0.483,13,0.543,9.1,2015-16
226,202322,John Wall,1610612764,WAS,77,37,40,2784.0,42,11,32,0.262,228,0.184,12,0.194,15.9,337,40,296,0.119,535,0.63,34,0.673,8.6,379,51,328,0.135,763,0.497,46,0.529,9.5,2015-16
227,203948,Johnny O'Bryant III,1610612749,MIL,66,27,39,857.0,65,47,16,0.723,143,0.455,7,0.478,5.0,111,41,72,0.369,223,0.498,15,0.534,6.3,176,88,88,0.5,366,0.481,22,0.512,5.9,2015-16
228,202720,Jon Leuer,1610612756,PHX,67,22,45,1255.0,76,47,26,0.618,195,0.39,6,0.402,6.5,297,94,200,0.316,461,0.644,38,0.702,3.9,373,141,226,0.378,656,0.569,44,0.609,4.4,2015-16
229,201973,Jonas Jerebko,1610612738,BOS,77,46,31,1160.0,74,46,28,0.622,192,0.385,6,0.398,8.3,208,55,152,0.264,348,0.598,25,0.644,5.5,282,101,180,0.358,540,0.522,31,0.554,6.2,2015-16
230,202685,Jonas Valanciunas,1610612761,TOR,59,39,20,1527.0,181,154,26,0.851,413,0.438,4,0.443,4.0,357,144,208,0.403,560,0.638,46,0.695,3.6,538,298,234,0.554,973,0.553,50,0.583,3.8,2015-16
231,203613,Jonathon Simmons,1610612759,SAS,55,47,8,813.0,16,6,10,0.375,64,0.25,4,0.267,16.0,80,14,65,0.175,140,0.571,21,0.672,7.6,96,20,75,0.208,204,0.471,25,0.536,9.0,2015-16
232,203919,Jordan Adams,1610612763,MEM,2,0,2,15.0,0,0,0,0.0,0,0.0,0,0.0,0.0,2,0,2,0.0,3,0.667,1,1.0,11.0,2,0,2,0.0,3,0.667,1,1.0,11.0,2015-16
233,203903,Jordan Clarkson,1610612747,LAL,79,17,62,2552.0,93,48,46,0.516,323,0.288,6,0.293,10.3,220,26,197,0.118,454,0.485,40,0.531,8.6,313,74,243,0.236,777,0.403,46,0.428,9.1,2015-16
234,200770,Jordan Farmar,1610612763,MEM,12,2,10,291.0,4,2,2,0.5,23,0.174,3,0.2,19.0,21,6,15,0.286,42,0.5,2,0.525,8.9,25,8,17,0.32,65,0.385,5,0.417,10.5,2015-16
235,202706,Jordan Hamilton,1610612740,NOP,11,4,7,304.0,12,8,4,0.667,36,0.333,2,0.353,9.7,50,8,42,0.16,88,0.568,9,0.633,5.7,62,16,46,0.258,124,0.5,11,0.549,6.4,2015-16
236,201941,Jordan Hill,1610612754,IND,73,40,33,1513.0,156,106,44,0.679,359,0.435,12,0.45,6.3,295,98,195,0.332,478,0.617,42,0.677,4.5,451,204,239,0.452,837,0.539,54,0.576,5.1,2015-16
237,203895,Jordan McRae,1610612739,CLE,22,10,12,196.0,4,2,3,0.5,15,0.267,0,0.267,9.0,16,0,16,0.0,28,0.571,4,0.667,8.9,20,2,19,0.1,43,0.465,4,0.513,8.9,2015-16
238,1626175,Jordan Mickey,1610612738,BOS,16,9,7,57.0,6,4,1,0.667,24,0.25,1,0.261,2.8,7,2,5,0.286,20,0.35,3,0.412,3.1,13,6,6,0.462,44,0.295,4,0.325,3.0,2015-16
239,203268,Jorge Gutierrez,1610612766,CHA,12,9,3,63.0,0,0,0,0.0,1,0.0,0,0.0,0.0,7,1,6,0.143,9,0.778,0,0.778,7.4,7,1,6,0.143,10,0.7,0,0.7,7.4,2015-16
240,101181,Jose Calderon,1610612752,NYK,72,29,43,2024.0,22,6,15,0.273,84,0.262,5,0.278,18.5,207,24,185,0.116,375,0.552,30,0.6,8.5,229,30,200,0.131,459,0.499,35,0.54,9.5,2015-16
241,203962,Josh Huestis,1610612760,OKC,5,2,3,55.0,2,2,0,1.0,8,0.25,2,0.333,7.8,8,3,5,0.375,13,0.615,2,0.727,5.6,10,5,5,0.5,21,0.476,4,0.588,6.0,2015-16
242,201177,Josh McRoberts,1610612748,MIA,42,27,15,595.0,22,11,11,0.5,49,0.449,1,0.458,8.4,83,31,53,0.373,167,0.497,10,0.529,5.7,105,42,64,0.4,216,0.486,11,0.512,6.3,2015-16
243,1626196,Josh Richardson,1610612748,MIA,52,29,23,1107.0,21,7,14,0.333,79,0.266,2,0.273,16.2,86,17,71,0.198,203,0.424,26,0.486,8.5,107,24,85,0.224,282,0.379,28,0.421,10.0,2015-16
244,2746,Josh Smith,1610612745,HOU,55,31,24,880.0,51,32,14,0.627,121,0.421,6,0.443,7.0,141,66,76,0.468,295,0.478,35,0.542,5.1,192,98,90,0.51,416,0.462,41,0.512,5.6,2015-16
245,201950,Jrue Holiday,1610612740,NOP,65,27,38,1831.0,27,19,9,0.704,141,0.191,7,0.201,9.6,168,30,138,0.179,312,0.538,32,0.6,7.7,195,49,147,0.251,453,0.43,39,0.471,8.0,2015-16
246,203944,Julius Randle,1610612747,LAL,81,17,64,2286.0,172,127,42,0.738,496,0.347,17,0.359,6.1,657,212,440,0.323,981,0.67,70,0.721,4.2,829,339,482,0.409,1477,0.561,87,0.596,4.6,2015-16
247,1626147,Justin Anderson,1610612742,DAL,55,28,27,647.0,18,5,13,0.278,51,0.353,2,0.367,12.2,114,25,88,0.219,176,0.648,13,0.699,4.7,132,30,101,0.227,227,0.581,15,0.623,5.7,2015-16
248,202712,Justin Harper,1610612751,BKN,5,4,1,35.0,0,0,0,0.0,1,0.0,0,0.0,0.0,1,1,0,1.0,2,0.5,1,1.0,4.9,1,1,0,1.0,3,0.333,1,0.5,4.9,2015-16
249,203200,Justin Holiday,1610612741,CHI,53,28,25,773.0,12,3,9,0.25,47,0.255,2,0.267,13.9,78,17,60,0.218,165,0.473,22,0.545,7.5,90,20,69,0.222,212,0.425,24,0.479,8.4,2015-16
250,1626159,Justise Winslow,1610612748,MIA,78,46,32,2232.0,81,43,37,0.531,259,0.313,11,0.327,7.1,322,99,222,0.307,613,0.525,64,0.587,6.0,403,142,259,0.352,872,0.462,75,0.506,6.2,2015-16
251,203994,Jusuf Nurkic,1610612743,DEN,32,14,18,547.0,65,50,15,0.769,159,0.409,1,0.411,4.7,110,38,66,0.345,207,0.531,25,0.604,4.3,175,88,81,0.503,366,0.478,26,0.515,4.5,2015-16
252,203909,KJ McDaniels,1610612745,HOU,37,17,20,235.0,16,10,7,0.625,33,0.485,0,0.485,4.9,26,8,18,0.308,57,0.456,3,0.481,6.8,42,18,25,0.429,90,0.467,3,0.483,6.1,2015-16
253,1626157,Karl-Anthony Towns,1610612750,MIN,82,29,53,2626.0,229,170,56,0.742,515,0.445,9,0.453,5.8,629,268,363,0.426,969,0.649,69,0.699,4.2,858,438,419,0.51,1484,0.578,78,0.61,4.6,2015-16
254,202695,Kawhi Leonard,1610612759,SAS,72,60,12,2380.0,95,41,49,0.432,193,0.492,9,0.516,10.9,398,110,287,0.276,553,0.72,41,0.777,6.4,493,151,336,0.306,746,0.661,50,0.708,7.2,2015-16
255,203951,Keith Appling,1610612753,ORL,5,0,5,27.0,0,0,0,0.0,0,0.0,0,0.0,0.0,1,0,1,0.0,5,0.2,0,0.2,7.9,1,0,1,0.0,5,0.2,0,0.2,7.9,2015-16
256,203482,Kelly Olynyk,1610612738,BOS,68,39,29,1370.0,71,45,25,0.634,222,0.32,8,0.332,6.9,206,56,149,0.272,373,0.552,37,0.613,5.3,277,101,174,0.365,595,0.466,45,0.504,5.7,2015-16
257,1626162,Kelly Oubre Jr.,1610612764,WAS,63,31,32,671.0,25,18,7,0.72,80,0.313,3,0.325,9.4,108,25,83,0.231,187,0.578,14,0.624,5.6,133,43,90,0.323,267,0.498,17,0.532,6.3,2015-16
258,202689,Kemba Walker,1610612766,CHA,81,47,34,2885.0,56,21,34,0.375,232,0.241,12,0.255,12.5,301,30,273,0.1,541,0.556,62,0.628,8.9,357,51,307,0.143,773,0.462,74,0.511,9.4,2015-16
259,203088,Kendall Marshall,1610612755,PHI,30,3,27,400.0,2,2,0,1.0,17,0.118,0,0.118,6.7,26,4,22,0.154,48,0.542,1,0.553,11.5,28,6,22,0.214,65,0.431,1,0.438,11.2,2015-16
260,2570,Kendrick Perkins,1610612740,NOP,37,13,24,542.0,25,16,6,0.64,73,0.342,2,0.352,4.2,103,20,82,0.194,178,0.579,15,0.632,4.8,128,36,88,0.281,251,0.51,17,0.547,4.7,2015-16
261,202702,Kenneth Faried,1610612743,DEN,67,26,41,1694.0,235,168,60,0.715,488,0.482,7,0.489,4.9,346,136,208,0.393,534,0.648,37,0.696,5.0,581,304,268,0.523,1022,0.568,44,0.594,4.9,2015-16
262,203145,Kent Bazemore,1610612737,ATL,75,44,31,2083.0,28,14,13,0.5,134,0.209,6,0.219,9.5,351,52,298,0.148,568,0.618,34,0.657,6.3,379,66,311,0.174,702,0.54,40,0.573,6.5,2015-16
263,203484,Kentavious Caldwell-Pope,1610612765,DET,76,41,35,2789.0,70,32,34,0.457,189,0.37,4,0.378,10.9,212,39,174,0.184,355,0.597,25,0.642,9.0,282,71,208,0.252,544,0.518,29,0.548,9.5,2015-16
264,201142,Kevin Durant,1610612760,OKC,72,52,20,2578.0,45,21,22,0.467,140,0.321,4,0.331,13.8,544,108,434,0.199,724,0.751,28,0.782,6.3,589,129,456,0.219,864,0.682,32,0.708,6.9,2015-16
265,708,Kevin Garnett,1610612750,MIN,38,14,24,556.0,15,8,7,0.533,38,0.395,0,0.395,12.4,135,31,102,0.23,215,0.628,11,0.662,4.8,150,39,109,0.26,253,0.593,11,0.62,5.6,2015-16
266,201567,Kevin Love,1610612739,CLE,77,53,24,2424.0,149,97,45,0.651,338,0.441,9,0.453,7.4,613,187,419,0.305,943,0.65,78,0.709,4.3,762,284,464,0.373,1281,0.595,87,0.638,4.9,2015-16
267,2755,Kevin Martin,1610612759,SAS,55,24,31,1095.0,14,4,11,0.286,67,0.209,2,0.215,13.8,96,17,78,0.177,154,0.623,10,0.667,7.4,110,21,89,0.191,221,0.498,12,0.526,8.2,2015-16
268,202338,Kevin Seraphin,1610612752,NYK,48,15,33,526.0,31,20,11,0.645,84,0.369,2,0.378,5.7,95,39,54,0.411,178,0.534,22,0.609,3.9,126,59,65,0.468,262,0.481,24,0.529,4.4,2015-16
269,1626172,Kevon Looney,1610612744,GSW,5,4,1,21.0,4,2,2,0.5,6,0.667,0,0.667,9.1,6,3,3,0.5,7,0.857,0,0.857,8.2,10,5,5,0.5,13,0.769,0,0.769,8.5,2015-16
270,203114,Khris Middleton,1610612749,MIL,79,33,46,2852.0,44,18,28,0.409,157,0.28,6,0.291,12.7,258,50,211,0.194,437,0.59,26,0.628,8.7,302,68,239,0.225,594,0.508,32,0.537,9.4,2015-16
271,2550,Kirk Hinrich,1610612737,ATL,46,26,20,631.0,8,2,6,0.25,42,0.19,1,0.195,18.4,62,8,56,0.129,131,0.473,13,0.525,11.3,70,10,62,0.143,173,0.405,14,0.44,12.1,2015-16
272,202691,Klay Thompson,1610612744,GSW,80,71,9,2666.0,35,13,22,0.371,147,0.238,7,0.25,13.6,271,67,204,0.247,541,0.501,57,0.56,7.5,306,80,226,0.261,688,0.445,64,0.49,8.3,2015-16
273,977,Kobe Bryant,1610612747,LAL,66,13,53,1863.0,41,16,24,0.39,158,0.259,6,0.27,13.4,206,21,188,0.102,319,0.646,21,0.691,7.5,247,37,212,0.15,477,0.518,27,0.549,8.4,2015-16
274,201585,Kosta Koufos,1610612758,SAC,77,32,45,1463.0,167,97,70,0.581,342,0.488,6,0.497,6.2,246,77,170,0.313,424,0.58,41,0.642,4.8,413,174,240,0.421,766,0.539,47,0.574,5.4,2015-16
275,203123,Kostas Papanikolaou,1610612743,DEN,26,8,18,294.0,8,3,4,0.375,42,0.19,0,0.19,9.4,32,9,24,0.281,65,0.492,3,0.516,6.3,40,12,28,0.3,107,0.374,3,0.385,6.9,2015-16
276,2743,Kris Humphries,1610612737,ATL,53,29,24,835.0,57,39,16,0.684,155,0.368,1,0.37,5.7,161,54,107,0.335,297,0.542,27,0.596,4.1,218,93,123,0.427,452,0.482,28,0.514,4.5,2015-16
277,204001,Kristaps Porzingis,1610612752,NYK,72,28,44,2047.0,132,86,45,0.652,265,0.498,5,0.508,7.6,394,130,257,0.33,647,0.609,55,0.666,4.8,526,216,302,0.411,912,0.577,60,0.617,5.5,2015-16
278,203937,Kyle Anderson,1610612759,SAS,78,64,14,1245.0,25,11,13,0.44,78,0.321,1,0.325,9.9,219,56,161,0.256,332,0.66,23,0.709,6.3,244,67,174,0.275,410,0.595,24,0.632,6.6,2015-16
279,2594,Kyle Korver,1610612737,ATL,80,46,34,2401.0,14,3,10,0.214,83,0.169,3,0.175,19.0,246,59,184,0.24,546,0.451,58,0.504,7.0,260,62,194,0.238,629,0.413,61,0.458,7.6,2015-16
280,200768,Kyle Lowry,1610612761,TOR,76,53,23,2804.0,54,28,27,0.519,291,0.186,7,0.19,9.1,303,66,239,0.218,599,0.506,53,0.555,8.4,357,94,266,0.263,890,0.401,60,0.43,8.5,2015-16
281,203124,Kyle O'Quinn,1610612752,NYK,65,26,39,764.0,76,55,20,0.724,152,0.5,5,0.517,6.4,174,83,91,0.477,289,0.602,29,0.669,4.1,250,138,111,0.552,441,0.567,34,0.614,4.8,2015-16
282,202713,Kyle Singler,1610612760,OKC,68,43,25,977.0,50,24,26,0.48,129,0.388,3,0.397,9.1,91,24,65,0.264,185,0.492,17,0.542,7.0,141,48,91,0.34,314,0.449,20,0.48,7.7,2015-16
283,202681,Kyrie Irving,1610612739,CLE,53,37,16,1667.0,44,20,21,0.455,149,0.295,6,0.308,12.6,113,14,98,0.124,239,0.473,25,0.528,8.7,157,34,119,0.217,388,0.405,31,0.44,9.7,2015-16
284,200746,LaMarcus Aldridge,1610612759,SAS,74,61,13,2261.0,176,127,46,0.722,366,0.481,8,0.492,5.0,456,138,312,0.303,632,0.722,43,0.774,5.2,632,265,358,0.419,998,0.633,51,0.667,5.2,2015-16
285,203934,Lamar Patterson,1610612737,ATL,35,23,12,395.0,4,2,3,0.5,20,0.2,0,0.2,7.2,46,11,36,0.239,79,0.582,5,0.622,6.1,50,13,39,0.26,99,0.505,5,0.532,6.4,2015-16
286,202362,Lance Stephenson,1610612763,MEM,69,36,33,1372.0,40,18,20,0.45,130,0.308,6,0.323,6.9,183,40,144,0.219,286,0.64,18,0.683,6.6,223,58,164,0.26,416,0.536,24,0.569,6.7,2015-16
287,202498,Lance Thomas,1610612752,NYK,59,25,34,1313.0,34,15,21,0.441,119,0.286,3,0.293,11.7,97,31,66,0.32,227,0.427,18,0.464,6.8,131,46,87,0.351,346,0.379,21,0.403,8.2,2015-16
288,204038,Langston Galloway,1610612752,NYK,82,32,50,2033.0,43,18,27,0.419,144,0.299,8,0.316,13.4,245,35,210,0.143,428,0.572,35,0.623,8.5,288,53,237,0.184,572,0.503,43,0.544,9.3,2015-16
289,1626204,Larry Nance Jr.,1610612747,LAL,63,14,49,1266.0,101,59,43,0.584,231,0.437,10,0.457,8.1,211,57,155,0.27,391,0.54,29,0.583,5.4,312,116,198,0.372,622,0.502,39,0.535,6.2,2015-16
290,202730,Lavoy Allen,1610612754,IND,79,43,36,1599.0,162,114,47,0.704,373,0.434,8,0.444,5.6,262,100,159,0.382,449,0.584,33,0.63,5.2,424,214,206,0.505,822,0.516,41,0.543,5.3,2015-16
291,2544,LeBron James,1610612739,CLE,76,56,20,2709.0,111,67,40,0.604,306,0.363,11,0.376,7.0,454,109,341,0.24,617,0.736,32,0.776,6.8,565,176,381,0.312,923,0.612,43,0.642,6.9,2015-16
292,2571,Leandro Barbosa,1610612744,GSW,68,60,8,1079.0,28,11,20,0.393,93,0.301,5,0.318,14.7,89,11,77,0.124,162,0.549,10,0.586,9.4,117,22,97,0.188,255,0.459,15,0.488,10.7,2015-16
293,203485,Lorenzo Brown,1610612765,DET,8,1,7,61.0,0,0,0,0.0,4,0.0,0,0.0,0.0,7,1,7,0.143,15,0.467,0,0.467,5.6,7,1,7,0.143,19,0.368,0,0.368,5.6,2015-16
294,200811,Lou Amundson,1610612752,NYK,29,11,18,204.0,23,16,6,0.696,55,0.418,1,0.426,9.6,26,11,16,0.423,58,0.448,6,0.5,4.3,49,27,22,0.551,113,0.434,7,0.462,6.7,2015-16
295,101150,Lou Williams,1610612747,LAL,67,14,53,1907.0,31,11,17,0.355,105,0.295,2,0.301,16.8,138,21,118,0.152,242,0.57,20,0.622,9.4,169,32,135,0.189,347,0.487,22,0.52,10.7,2015-16
296,201601,Luc Mbah a Moute,1610612746,LAC,75,49,26,1274.0,60,32,28,0.533,138,0.435,3,0.444,8.4,111,29,79,0.261,258,0.43,27,0.481,7.9,171,61,107,0.357,396,0.432,30,0.467,8.1,2015-16
297,203512,Lucas Nogueira,1610612761,TOR,29,17,12,225.0,18,13,5,0.722,39,0.462,0,0.462,5.4,28,13,15,0.464,55,0.509,5,0.56,4.5,46,26,20,0.565,94,0.489,5,0.517,4.8,2015-16
298,1626242,Luis Montero,1610612757,POR,12,6,6,42.0,0,0,0,0.0,4,0.0,0,0.0,0.0,4,1,3,0.25,7,0.571,0,0.571,13.5,4,1,3,0.25,11,0.364,0,0.364,13.5,2015-16
299,2449,Luis Scola,1610612761,TOR,75,49,26,1617.0,83,47,33,0.566,227,0.366,3,0.371,6.7,275,94,179,0.342,477,0.577,38,0.626,4.5,358,141,212,0.394,704,0.509,41,0.54,5.0,2015-16
300,202337,Luke Babbitt,1610612740,NOP,47,16,31,845.0,25,13,11,0.52,78,0.321,1,0.325,8.3,123,18,102,0.146,189,0.651,13,0.699,5.5,148,31,113,0.209,267,0.554,14,0.585,6.0,2015-16
301,2736,Luol Deng,1610612748,MIA,74,45,29,2394.0,108,67,40,0.62,254,0.425,9,0.441,6.5,335,91,238,0.272,597,0.561,54,0.617,7.1,443,158,278,0.357,851,0.521,63,0.562,7.0,2015-16
302,1938,Manu Ginobili,1610612759,SAS,58,47,11,1134.0,26,15,12,0.577,87,0.299,2,0.306,9.4,120,27,92,0.225,207,0.58,14,0.622,8.7,146,42,104,0.288,294,0.497,16,0.525,8.9,2015-16
303,201188,Marc Gasol,1610612763,MEM,52,30,22,1791.0,58,33,25,0.569,148,0.392,3,0.4,7.4,304,126,175,0.414,505,0.602,38,0.651,5.2,362,159,200,0.439,653,0.554,41,0.592,5.6,2015-16
304,1626273,Marcelo Huertas,1610612747,LAL,53,8,45,869.0,18,5,13,0.278,66,0.273,3,0.286,15.1,72,3,67,0.042,144,0.5,6,0.522,11.0,90,8,80,0.089,210,0.429,9,0.448,11.8,2015-16
305,101162,Marcin Gortat,1610612764,WAS,75,35,40,2256.0,222,140,79,0.631,487,0.456,14,0.469,6.6,519,148,366,0.285,877,0.592,87,0.657,4.3,741,288,445,0.389,1364,0.543,101,0.587,5.0,2015-16
306,201158,Marco Belinelli,1610612758,SAC,67,27,40,1646.0,10,2,8,0.2,58,0.172,1,0.175,19.1,104,14,90,0.135,218,0.477,27,0.545,7.7,114,16,98,0.14,276,0.413,28,0.46,8.7,2015-16
307,202694,Marcus Morris Sr.,1610612765,DET,80,42,38,2856.0,91,49,36,0.538,273,0.333,4,0.338,9.1,313,76,234,0.243,537,0.583,42,0.632,6.4,404,125,270,0.309,810,0.499,46,0.529,7.0,2015-16
308,203935,Marcus Smart,1610612738,BOS,61,36,25,1667.0,76,47,29,0.618,219,0.347,8,0.36,7.5,179,47,133,0.263,302,0.593,27,0.651,7.4,255,94,162,0.369,521,0.489,35,0.525,7.4,2015-16
309,201977,Marcus Thornton,1610612764,WAS,61,32,29,1108.0,38,18,21,0.474,130,0.292,6,0.306,9.6,112,14,97,0.125,204,0.549,24,0.622,8.1,150,32,118,0.213,334,0.449,30,0.493,8.5,2015-16
310,201596,Mario Chalmers,1610612748,MIA,61,38,23,1373.0,24,11,16,0.458,91,0.264,3,0.273,7.5,133,18,116,0.135,247,0.538,17,0.578,8.6,157,29,132,0.185,338,0.464,20,0.494,8.6,2015-16
311,1626209,Mario Hezonja,1610612753,ORL,78,33,45,1399.0,28,16,12,0.571,90,0.311,1,0.315,7.5,146,28,120,0.192,252,0.579,24,0.64,5.9,174,44,132,0.253,342,0.509,25,0.549,6.2,2015-16
312,203900,Markel Brown,1610612751,BKN,62,12,50,982.0,23,7,14,0.304,91,0.253,4,0.264,9.7,99,18,81,0.182,182,0.544,18,0.604,7.3,122,25,95,0.205,273,0.447,22,0.486,7.7,2015-16
313,202693,Markieff Morris,1610612764,WAS,64,22,42,1629.0,73,39,31,0.534,180,0.406,7,0.422,8.2,279,103,174,0.369,408,0.684,32,0.742,5.7,352,142,205,0.403,588,0.599,39,0.641,6.2,2015-16
314,201578,Marreese Speights,1610612744,GSW,72,64,8,832.0,77,51,23,0.662,183,0.421,3,0.428,5.4,162,73,87,0.451,289,0.561,20,0.602,4.6,239,124,110,0.519,472,0.506,23,0.532,4.9,2015-16
315,101107,Marvin Williams,1610612766,CHA,81,47,34,2338.0,127,79,42,0.622,247,0.514,5,0.525,7.5,394,104,288,0.264,665,0.592,43,0.633,5.6,521,183,330,0.351,912,0.571,48,0.603,6.0,2015-16
316,203486,Mason Plumlee,1610612757,POR,82,44,38,2084.0,201,135,62,0.672,495,0.406,10,0.414,6.9,427,145,279,0.34,760,0.562,67,0.616,4.4,628,280,341,0.446,1255,0.5,77,0.533,5.2,2015-16
317,2440,Matt Barnes,1610612763,MEM,76,38,38,2190.0,84,47,31,0.56,233,0.361,10,0.377,7.4,336,67,261,0.199,509,0.66,29,0.7,6.1,420,114,292,0.271,742,0.566,39,0.597,6.3,2015-16
318,2588,Matt Bonner,1610612759,SAS,30,25,5,206.0,3,1,2,0.333,12,0.25,0,0.25,12.8,24,6,18,0.25,45,0.533,6,0.615,5.8,27,7,20,0.259,57,0.474,6,0.529,6.6,2015-16
319,203521,Matthew Dellavedova,1610612739,CLE,76,54,22,1867.0,33,12,21,0.364,115,0.287,3,0.295,15.3,129,23,109,0.178,293,0.44,30,0.49,10.0,162,35,130,0.216,408,0.397,33,0.432,11.1,2015-16
320,203090,Maurice Harkless,1610612757,POR,78,40,38,1457.0,101,59,39,0.584,228,0.443,4,0.451,7.8,179,56,122,0.313,320,0.559,27,0.611,5.5,280,115,161,0.411,548,0.511,31,0.542,6.3,2015-16
321,1897,Metta World Peace,1610612747,LAL,35,6,29,590.0,19,13,6,0.684,74,0.257,2,0.264,7.4,70,10,61,0.143,132,0.53,10,0.574,7.9,89,23,67,0.258,206,0.432,12,0.459,7.8,2015-16
322,203086,Meyers Leonard,1610612757,POR,61,33,28,1333.0,51,32,21,0.627,124,0.411,4,0.425,6.5,263,82,177,0.312,414,0.635,24,0.674,4.2,314,114,198,0.363,538,0.584,28,0.616,4.6,2015-16
323,201563,Michael Beasley,1610612745,HOU,20,10,10,363.0,29,21,8,0.724,72,0.403,1,0.408,4.7,69,30,39,0.435,114,0.605,9,0.657,4.5,98,51,47,0.52,186,0.527,10,0.557,4.6,2015-16
324,203487,Michael Carter-Williams,1610612749,MIL,54,21,33,1649.0,48,35,15,0.729,172,0.279,6,0.289,6.9,228,59,170,0.259,399,0.571,35,0.626,7.2,276,94,185,0.341,571,0.483,41,0.521,7.2,2015-16
325,203077,Michael Kidd-Gilchrist,1610612766,CHA,7,5,2,205.0,12,10,1,0.833,38,0.316,2,0.333,5.9,33,11,22,0.333,55,0.6,6,0.673,5.1,45,21,23,0.467,93,0.484,8,0.529,5.3,2015-16
326,201144,Mike Conley,1610612763,MEM,56,33,23,1760.0,26,8,18,0.308,109,0.239,4,0.248,13.3,138,20,123,0.145,289,0.478,27,0.527,9.6,164,28,141,0.171,398,0.412,31,0.447,10.1,2015-16
327,2399,Mike Dunleavy,1610612741,CHI,31,13,18,703.0,8,6,1,0.75,48,0.167,1,0.17,4.0,75,16,61,0.213,160,0.469,23,0.547,6.1,83,22,62,0.265,208,0.399,24,0.451,5.9,2015-16
328,2034,Mike Miller,1610612743,DEN,47,21,26,373.0,6,1,4,0.167,15,0.4,1,0.429,12.6,47,7,40,0.149,85,0.553,5,0.588,6.0,53,8,44,0.151,100,0.53,6,0.564,6.6,2015-16
329,203488,Mike Muscala,1610612737,ATL,60,34,26,565.0,38,25,12,0.658,92,0.413,1,0.418,4.3,79,32,43,0.405,188,0.42,18,0.465,4.6,117,57,55,0.487,280,0.418,19,0.448,4.5,2015-16
330,203118,Mike Scott,1610612737,ATL,75,46,29,1146.0,53,36,17,0.679,145,0.366,1,0.368,6.1,153,43,111,0.281,301,0.508,23,0.55,6.7,206,79,128,0.383,446,0.462,24,0.488,6.6,2015-16
331,203101,Miles Plumlee,1610612749,MIL,61,23,38,870.0,94,53,39,0.564,190,0.495,8,0.516,6.0,138,47,89,0.341,273,0.505,25,0.556,4.9,232,100,128,0.431,463,0.501,33,0.54,5.3,2015-16
332,203141,Mirza Teletovic,1610612756,PHX,79,23,56,1685.0,55,32,22,0.582,167,0.329,7,0.344,8.3,247,84,165,0.34,449,0.55,39,0.602,4.8,302,116,187,0.384,616,0.49,46,0.53,5.4,2015-16
333,203956,Mitch McGary,1610612760,OKC,20,17,3,72.0,4,2,1,0.5,13,0.308,0,0.308,6.0,14,2,11,0.143,24,0.583,3,0.667,5.5,18,4,12,0.222,37,0.486,3,0.529,5.6,2015-16
334,2590,Mo Williams,1610612739,CLE,41,27,14,748.0,6,1,7,0.167,43,0.14,3,0.15,10.7,66,4,65,0.061,132,0.5,11,0.545,10.9,72,5,72,0.069,175,0.411,14,0.447,11.3,2015-16
335,101145,Monta Ellis,1610612754,IND,81,44,37,2734.0,42,18,27,0.429,172,0.244,7,0.255,15.3,229,23,205,0.1,423,0.541,27,0.578,8.8,271,41,232,0.151,595,0.455,34,0.483,10.0,2015-16
336,1626149,Montrezl Harrell,1610612745,HOU,39,17,22,379.0,25,11,12,0.44,54,0.463,0,0.463,7.2,40,16,23,0.4,74,0.541,2,0.556,6.3,65,27,35,0.415,128,0.508,2,0.516,6.7,2015-16
337,1626167,Myles Turner,1610612754,IND,60,32,28,1367.0,68,46,20,0.676,189,0.36,4,0.368,6.7,264,114,150,0.432,514,0.514,42,0.559,4.5,332,160,170,0.482,703,0.472,46,0.505,5.0,2015-16
338,101126,Nate Robinson,1610612740,NOP,2,0,2,23.0,0,0,0,0.0,0,0.0,0,0.0,0.0,0,0,0,0.0,5,0.0,1,0.0,0.0,0,0,0,0.0,5,0.0,1,0.0,0.0,2015-16
339,1737,Nazr Mohammed,1610612760,OKC,5,5,0,19.0,1,1,0,1.0,2,0.5,0,0.5,2.7,3,2,1,0.667,5,0.6,1,0.75,3.4,4,3,1,0.75,7,0.571,1,0.667,3.2,2015-16
340,202357,Nemanja Bjelica,1610612750,MIN,60,20,40,1075.0,49,36,12,0.735,111,0.441,3,0.454,7.7,161,54,108,0.335,305,0.528,27,0.579,4.8,210,90,120,0.429,416,0.505,30,0.544,5.5,2015-16
341,2403,Nene,1610612764,WAS,57,28,29,1094.0,52,38,14,0.731,155,0.335,2,0.34,7.3,207,72,134,0.348,352,0.588,43,0.67,5.0,259,110,148,0.425,507,0.511,45,0.561,5.4,2015-16
342,203457,Nerlens Noel,1610612755,PHI,67,10,57,1965.0,154,103,48,0.669,380,0.405,14,0.421,6.4,388,129,256,0.332,683,0.568,64,0.627,4.0,542,232,304,0.428,1063,0.51,78,0.55,4.6,2015-16
343,2555,Nick Collison,1610612760,OKC,59,39,20,699.0,68,52,16,0.765,150,0.453,3,0.463,6.1,103,34,68,0.33,186,0.554,19,0.617,5.1,171,86,84,0.503,336,0.509,22,0.545,5.5,2015-16
344,201156,Nick Young,1610612747,LAL,54,13,41,1033.0,14,3,11,0.214,66,0.212,1,0.215,15.8,83,23,60,0.277,184,0.451,12,0.483,7.2,97,26,71,0.268,250,0.388,13,0.409,8.4,2015-16
345,201587,Nicolas Batum,1610612766,CHA,70,41,29,2448.0,55,25,30,0.455,202,0.272,7,0.282,11.8,373,65,308,0.174,567,0.658,30,0.695,6.4,428,90,338,0.21,769,0.557,37,0.585,7.1,2015-16
346,203917,Nik Stauskas,1610612755,PHI,73,8,65,1809.0,23,8,14,0.348,108,0.213,4,0.221,12.9,160,21,137,0.131,293,0.546,23,0.593,7.4,183,29,151,0.158,401,0.456,27,0.489,8.1,2015-16
347,203999,Nikola Jokic,1610612743,DEN,80,31,49,1733.0,181,127,49,0.702,422,0.429,8,0.437,5.5,379,153,225,0.404,642,0.59,57,0.648,4.3,560,280,274,0.5,1064,0.526,65,0.561,4.7,2015-16
348,202703,Nikola Mirotic,1610612741,CHI,66,37,29,1646.0,58,33,26,0.569,156,0.372,1,0.374,7.1,304,73,228,0.24,511,0.595,40,0.645,5.0,362,106,254,0.293,667,0.543,41,0.578,5.4,2015-16
349,201593,Nikola Pekovic,1610612750,MIN,12,2,10,156.0,7,6,1,0.857,23,0.304,2,0.333,3.7,14,5,8,0.357,32,0.438,7,0.56,5.6,21,11,9,0.524,55,0.382,9,0.457,4.9,2015-16
350,202696,Nikola Vucevic,1610612753,ORL,64,28,36,1998.0,172,100,65,0.581,347,0.496,11,0.512,6.5,393,166,229,0.422,635,0.619,53,0.675,4.3,565,266,294,0.471,982,0.575,64,0.615,4.9,2015-16
351,203943,Noah Vonleh,1610612757,POR,78,41,37,1174.0,91,62,28,0.681,231,0.394,8,0.408,6.0,214,77,135,0.36,359,0.596,38,0.667,4.5,305,139,163,0.456,590,0.517,46,0.561,4.9,2015-16
352,1626181,Norman Powell,1610612761,TOR,48,31,17,722.0,16,5,11,0.313,58,0.276,3,0.291,16.6,94,16,78,0.17,157,0.599,13,0.653,8.0,110,21,89,0.191,215,0.512,16,0.553,9.3,2015-16
353,202708,Norris Cole,1610612740,NOP,45,20,25,1198.0,10,1,9,0.1,62,0.161,2,0.167,17.7,141,23,118,0.163,223,0.632,23,0.705,9.3,151,24,127,0.159,285,0.53,25,0.581,9.9,2015-16
354,201564,O.J. Mayo,1610612749,MIL,41,17,24,1090.0,13,3,9,0.231,58,0.224,1,0.228,13.7,92,15,78,0.163,190,0.484,17,0.532,8.7,105,18,87,0.171,248,0.423,18,0.457,9.3,2015-16
355,201600,Omer Asik,1610612740,NOP,68,29,39,1178.0,120,83,30,0.692,270,0.444,2,0.448,5.5,294,98,195,0.333,476,0.618,46,0.684,4.1,414,181,225,0.437,746,0.555,48,0.593,4.5,2015-16
356,201956,Omri Casspi,1610612758,SAC,69,27,42,1880.0,58,28,29,0.483,203,0.286,8,0.297,8.0,352,70,283,0.199,609,0.578,53,0.633,4.8,410,98,312,0.239,812,0.505,61,0.546,5.2,2015-16
357,203111,Orlando Johnson,1610612740,NOP,7,1,6,102.0,4,2,3,0.5,12,0.333,0,0.333,7.1,11,1,10,0.091,30,0.367,3,0.407,6.9,15,3,13,0.2,42,0.357,3,0.385,7.0,2015-16
358,203490,Otto Porter Jr.,1610612764,WAS,75,36,39,2276.0,97,55,41,0.567,286,0.339,9,0.35,8.1,294,81,212,0.276,501,0.587,33,0.628,5.4,391,136,253,0.348,787,0.497,42,0.525,6.0,2015-16
359,200782,P.J. Tucker,1610612756,PHX,82,23,59,2540.0,165,102,56,0.618,426,0.387,17,0.403,7.2,347,90,255,0.259,486,0.714,40,0.778,6.3,512,192,311,0.375,912,0.561,57,0.599,6.6,2015-16
360,203798,PJ Hairston,1610612763,MEM,66,31,35,1313.0,25,11,15,0.44,98,0.255,2,0.26,11.2,149,27,121,0.181,265,0.562,19,0.606,6.9,174,38,136,0.218,363,0.479,21,0.509,7.5,2015-16
361,203143,Pablo Prigioni,1610612746,LAC,59,37,22,823.0,38,13,26,0.342,100,0.38,2,0.388,13.8,76,11,66,0.145,147,0.517,9,0.551,8.6,114,24,92,0.211,247,0.462,11,0.483,10.3,2015-16
362,1626192,Pat Connaughton,1610612757,POR,34,17,17,143.0,11,3,7,0.273,17,0.647,0,0.647,8.1,21,7,15,0.333,40,0.525,1,0.538,5.9,32,10,22,0.313,57,0.561,1,0.571,6.6,2015-16
363,201976,Patrick Beverley,1610612745,HOU,71,35,36,2041.0,73,39,33,0.534,199,0.367,6,0.378,9.7,177,28,146,0.158,341,0.519,29,0.567,8.8,250,67,179,0.268,540,0.463,35,0.495,9.1,2015-16
364,202335,Patrick Patterson,1610612761,TOR,78,53,25,1984.0,76,46,27,0.605,144,0.528,3,0.539,8.5,259,86,171,0.332,487,0.532,27,0.563,6.2,335,132,198,0.394,631,0.531,30,0.557,6.7,2015-16
365,201988,Patty Mills,1610612759,SAS,81,66,15,1662.0,27,4,23,0.148,91,0.297,4,0.31,15.5,131,10,121,0.076,237,0.553,16,0.593,10.1,158,14,144,0.089,328,0.482,20,0.513,11.1,2015-16
366,2200,Pau Gasol,1610612741,CHI,72,36,36,2291.0,155,108,45,0.697,336,0.461,10,0.475,6.1,638,231,400,0.362,1035,0.616,85,0.672,4.4,793,339,445,0.427,1371,0.578,95,0.621,4.7,2015-16
367,202331,Paul George,1610612754,IND,81,44,37,2819.0,79,39,41,0.494,261,0.303,4,0.307,11.2,484,90,395,0.186,773,0.626,60,0.679,6.3,563,129,436,0.229,1034,0.544,64,0.58,7.0,2015-16
368,200794,Paul Millsap,1610612737,ATL,81,48,33,2647.0,198,139,60,0.702,452,0.438,9,0.447,7.3,534,182,351,0.341,942,0.567,78,0.618,4.9,732,321,411,0.439,1394,0.525,87,0.56,5.5,2015-16
369,1718,Paul Pierce,1610612746,LAC,68,44,24,1231.0,12,3,9,0.25,55,0.218,3,0.231,16.6,174,57,112,0.328,353,0.493,33,0.544,5.5,186,60,121,0.323,408,0.456,36,0.5,6.3,2015-16
370,203515,Phil Pressey,1610612757,POR,23,3,20,283.0,3,0,3,0.0,21,0.143,2,0.158,19.9,28,2,26,0.071,48,0.583,2,0.609,11.3,31,2,29,0.065,69,0.449,4,0.477,12.2,2015-16
371,203112,Quincy Acy,1610612758,SAC,58,21,37,869.0,64,40,21,0.625,158,0.405,7,0.424,5.7,123,32,89,0.26,224,0.549,22,0.609,4.4,187,72,110,0.385,382,0.49,29,0.53,4.9,2015-16
372,1626154,RJ Hunter,1610612738,BOS,35,20,15,307.0,2,0,2,0.0,8,0.25,0,0.25,15.6,34,6,28,0.176,50,0.68,1,0.694,8.1,36,6,30,0.167,58,0.621,1,0.632,8.5,2015-16
373,200765,Rajon Rondo,1610612758,SAC,71,29,42,2513.0,77,30,43,0.39,282,0.273,10,0.283,12.0,355,38,315,0.107,628,0.565,50,0.614,8.7,432,68,358,0.157,910,0.475,60,0.508,9.2,2015-16
374,1626176,Rakeem Christmas,1610612754,IND,1,1,0,6.0,1,0,1,0.0,1,1.0,0,1.0,6.5,0,0,0,0.0,1,0.0,0,0.0,0.0,1,0,1,0.0,2,0.5,0,0.5,6.5,2015-16
375,201196,Ramon Sessions,1610612764,WAS,82,41,41,1667.0,25,6,19,0.24,124,0.202,3,0.207,16.0,178,19,158,0.107,276,0.645,16,0.685,9.2,203,25,177,0.123,400,0.508,19,0.533,10.0,2015-16
376,200751,Randy Foye,1610612760,OKC,81,37,44,1641.0,24,4,18,0.167,106,0.226,3,0.233,19.2,132,28,104,0.212,258,0.512,21,0.557,8.9,156,32,122,0.205,364,0.429,24,0.459,10.3,2015-16
377,1626173,Rashad Vaughn,1610612749,MIL,70,30,40,1001.0,11,6,6,0.545,58,0.19,1,0.193,9.8,77,19,58,0.247,165,0.467,11,0.5,6.3,88,25,64,0.284,223,0.395,12,0.417,6.8,2015-16
378,2446,Rasual Butler,1610612759,SAS,46,41,5,431.0,3,2,1,0.667,20,0.15,2,0.167,12.0,53,13,40,0.245,97,0.546,10,0.609,6.7,56,15,41,0.268,117,0.479,12,0.533,7.0,2015-16
379,203526,Raul Neto,1610612762,UTA,81,40,41,1499.0,17,4,13,0.235,82,0.207,2,0.213,20.2,103,14,90,0.136,213,0.484,11,0.51,10.5,120,18,103,0.15,295,0.407,13,0.426,11.9,2015-16
380,203492,Ray McCallum,1610612759,SAS,41,30,11,474.0,8,2,6,0.25,37,0.216,1,0.222,13.3,39,7,30,0.179,87,0.448,6,0.481,9.8,47,9,36,0.191,124,0.379,7,0.402,10.4,2015-16
381,101109,Raymond Felton,1610612742,DAL,80,40,40,2192.0,36,18,18,0.5,135,0.267,11,0.29,11.7,222,30,192,0.135,420,0.529,33,0.574,7.8,258,48,210,0.186,555,0.465,44,0.505,8.4,2015-16
382,203493,Reggie Bullock,1610612765,DET,37,22,15,429.0,14,5,8,0.357,44,0.318,2,0.333,10.7,54,7,45,0.13,93,0.581,14,0.684,5.7,68,12,53,0.176,137,0.496,16,0.562,6.7,2015-16
383,202704,Reggie Jackson,1610612765,DET,79,43,36,2424.0,58,28,32,0.483,205,0.283,8,0.294,10.9,195,22,172,0.113,403,0.484,39,0.536,8.9,253,50,204,0.198,608,0.416,47,0.451,9.4,2015-16
384,2210,Richard Jefferson,1610612739,CLE,74,51,23,1326.0,15,7,8,0.467,97,0.155,2,0.158,12.7,113,24,88,0.212,243,0.465,26,0.521,6.2,128,31,96,0.242,340,0.376,28,0.41,7.0,2015-16
385,1626158,Richaun Holmes,1610612755,PHI,51,7,44,702.0,62,47,14,0.758,156,0.397,5,0.411,5.4,73,34,39,0.466,189,0.386,20,0.432,5.0,135,81,53,0.6,345,0.391,25,0.422,5.2,2015-16
386,201937,Ricky Rubio,1610612750,MIN,76,28,48,2323.0,40,7,33,0.175,150,0.267,10,0.286,15.3,286,47,237,0.164,492,0.581,43,0.637,9.5,326,54,270,0.166,642,0.508,53,0.553,10.2,2015-16
387,203496,Robert Covington,1610612755,PHI,67,10,57,1903.0,65,42,22,0.646,202,0.322,3,0.327,8.8,354,108,242,0.305,555,0.638,43,0.691,4.8,419,150,264,0.358,757,0.554,46,0.589,5.4,2015-16
388,203135,Robert Sacre,1610612747,LAL,25,2,23,320.0,32,19,12,0.594,82,0.39,2,0.4,5.9,40,19,23,0.475,82,0.488,14,0.588,5.8,72,38,35,0.528,164,0.439,16,0.486,5.8,2015-16
389,201577,Robin Lopez,1610612752,NYK,82,32,50,2219.0,268,204,56,0.761,546,0.491,9,0.499,4.7,334,146,185,0.437,673,0.496,61,0.546,5.2,602,350,241,0.581,1219,0.494,70,0.524,5.0,2015-16
390,203918,Rodney Hood,1610612762,UTA,79,39,40,2541.0,38,13,25,0.342,151,0.252,6,0.262,12.8,229,36,193,0.157,430,0.533,42,0.59,8.4,267,49,218,0.184,581,0.46,48,0.501,9.1,2015-16
391,201155,Rodney Stuckey,1610612754,IND,58,33,25,1275.0,19,6,13,0.316,84,0.226,2,0.232,14.4,137,31,107,0.226,227,0.604,11,0.634,8.3,156,37,120,0.237,311,0.502,13,0.523,9.1,2015-16
392,1626178,Rondae Hollis-Jefferson,1610612751,BKN,29,7,22,615.0,39,22,15,0.564,87,0.448,2,0.459,8.4,115,35,81,0.304,190,0.605,17,0.665,5.6,154,57,96,0.37,277,0.556,19,0.597,6.2,2015-16
393,101179,Ronnie Price,1610612756,PHX,62,20,42,1211.0,25,9,16,0.36,95,0.263,3,0.272,13.9,74,6,70,0.081,136,0.544,10,0.587,11.7,99,15,86,0.152,231,0.429,13,0.454,12.2,2015-16
394,201579,Roy Hibbert,1610612747,LAL,81,17,64,1878.0,132,88,40,0.667,351,0.376,13,0.391,4.8,266,93,172,0.35,545,0.488,55,0.543,5.3,398,181,212,0.455,896,0.444,68,0.481,5.1,2015-16
395,200752,Rudy Gay,1610612758,SAC,69,29,40,2348.0,103,65,31,0.631,302,0.341,11,0.354,6.0,346,96,254,0.277,528,0.655,30,0.695,6.2,449,161,285,0.359,830,0.541,41,0.569,6.2,2015-16
396,203497,Rudy Gobert,1610612762,UTA,61,33,28,1932.0,208,153,55,0.736,475,0.438,11,0.448,5.1,460,148,310,0.322,747,0.616,54,0.664,3.8,668,301,365,0.451,1222,0.547,65,0.577,4.2,2015-16
397,203893,Russ Smith,1610612763,MEM,15,6,9,66.0,1,0,1,0.0,8,0.125,1,0.143,17.9,8,0,7,0.0,10,0.8,0,0.8,11.6,9,0,8,0.0,18,0.5,1,0.529,12.4,2015-16
398,201566,Russell Westbrook,1610612760,OKC,80,55,25,2749.0,145,74,68,0.51,422,0.344,11,0.353,8.7,481,81,401,0.168,739,0.651,42,0.69,7.3,626,155,469,0.248,1161,0.539,53,0.565,7.6,2015-16
399,201583,Ryan Anderson,1610612740,NOP,66,24,42,2008.0,131,95,31,0.725,316,0.415,3,0.419,4.6,265,108,161,0.408,480,0.552,46,0.611,5.2,396,203,192,0.513,796,0.497,49,0.53,5.0,2015-16
400,200797,Ryan Hollins,1610612763,MEM,37,18,19,460.0,47,29,16,0.617,121,0.388,5,0.405,6.9,51,20,31,0.392,137,0.372,17,0.425,4.8,98,49,47,0.5,258,0.38,22,0.415,5.8,2015-16
401,203527,Ryan Kelly,1610612747,LAL,36,3,33,470.0,21,7,14,0.333,59,0.356,4,0.382,8.6,100,29,69,0.29,140,0.714,8,0.758,4.8,121,36,83,0.298,199,0.608,12,0.647,5.5,2015-16
402,1626257,Salah Mejri,1610612742,DAL,34,16,18,397.0,41,23,14,0.561,82,0.5,1,0.506,6.8,82,36,46,0.439,149,0.55,11,0.594,4.7,123,59,60,0.48,231,0.532,12,0.562,5.4,2015-16
403,1626155,Sam Dekker,1610612745,HOU,3,1,2,6.0,0,0,0,0.0,0,0.0,0,0.0,0.0,1,0,1,0.0,1,1.0,0,1.0,13.8,1,0,1,0.0,1,1.0,0,1.0,13.8,2015-16
404,201619,Sasha Kaun,1610612739,CLE,25,18,7,95.0,12,8,3,0.667,31,0.387,0,0.387,5.5,14,4,10,0.286,29,0.483,2,0.519,7.7,26,12,13,0.462,60,0.433,2,0.448,6.7,2015-16
405,2756,Sasha Vujacic,1610612752,NYK,61,22,39,908.0,26,11,16,0.423,72,0.361,4,0.382,15.8,123,18,105,0.146,221,0.557,21,0.615,8.4,149,29,121,0.195,293,0.509,25,0.556,9.7,2015-16
406,203930,Sean Kilpatrick,1610612751,BKN,31,7,24,616.0,12,4,7,0.333,56,0.214,0,0.214,11.1,44,3,42,0.068,80,0.55,8,0.611,7.7,56,7,49,0.125,136,0.412,8,0.438,8.4,2015-16
407,201586,Serge Ibaka,1610612760,OKC,78,54,24,2500.0,141,84,52,0.596,298,0.473,11,0.491,7.6,392,118,270,0.301,741,0.529,69,0.583,4.8,533,202,322,0.379,1039,0.513,80,0.556,5.5,2015-16
408,203508,Sergey Karasev,1610612751,BKN,40,9,31,399.0,8,3,4,0.375,30,0.267,0,0.267,5.6,50,15,35,0.3,91,0.549,9,0.61,7.0,58,18,39,0.31,121,0.479,9,0.518,6.9,2015-16
409,203552,Seth Curry,1610612758,SAC,43,17,26,669.0,9,3,6,0.333,46,0.196,2,0.205,20.3,49,5,44,0.102,107,0.458,6,0.485,12.2,58,8,50,0.138,153,0.379,8,0.4,13.4,2015-16
410,203498,Shabazz Muhammad,1610612750,MIN,82,29,53,1682.0,100,58,41,0.58,252,0.397,9,0.412,6.3,167,57,109,0.341,298,0.56,17,0.594,7.0,267,115,150,0.431,550,0.485,26,0.51,6.7,2015-16
411,203894,Shabazz Napier,1610612753,ORL,55,23,32,600.0,9,2,7,0.222,36,0.25,0,0.25,11.9,46,9,36,0.196,72,0.639,7,0.708,8.9,55,11,43,0.2,108,0.509,7,0.545,9.4,2015-16
412,203499,Shane Larkin,1610612751,BKN,78,20,58,1751.0,28,6,25,0.214,108,0.259,6,0.275,16.0,152,15,139,0.099,292,0.521,26,0.571,8.5,180,21,164,0.117,400,0.45,32,0.489,9.7,2015-16
413,2733,Shaun Livingston,1610612744,GSW,78,69,9,1520.0,42,18,25,0.429,144,0.292,5,0.302,11.6,127,32,93,0.252,269,0.472,13,0.496,8.0,169,50,118,0.296,413,0.409,18,0.428,9.0,2015-16
414,203963,Shayne Whittington,1610612754,IND,7,4,3,41.0,5,4,2,0.8,10,0.5,0,0.5,5.1,7,3,4,0.429,15,0.467,1,0.5,4.0,12,7,6,0.583,25,0.48,1,0.5,4.5,2015-16
415,202714,Shelvin Mack,1610612762,UTA,52,27,25,1058.0,13,5,10,0.385,67,0.194,0,0.194,15.3,115,21,95,0.183,216,0.532,23,0.596,8.0,128,26,105,0.203,283,0.452,23,0.492,8.9,2015-16
416,203524,Solomon Hill,1610612754,IND,59,31,28,866.0,39,23,13,0.59,108,0.361,5,0.379,7.2,127,30,96,0.236,233,0.545,20,0.596,6.0,166,53,109,0.319,341,0.487,25,0.525,6.3,2015-16
417,201603,Sonny Weems,1610612756,PHX,43,6,37,498.0,7,3,5,0.429,37,0.189,3,0.206,17.1,46,7,39,0.152,77,0.597,6,0.648,5.9,53,10,44,0.189,114,0.465,9,0.505,7.5,2015-16
418,203915,Spencer Dinwiddie,1610612741,CHI,12,5,7,159.0,4,2,2,0.5,11,0.364,0,0.364,8.0,13,1,12,0.077,25,0.52,1,0.542,8.5,17,3,14,0.176,36,0.472,1,0.486,8.4,2015-16
419,201150,Spencer Hawes,1610612766,CHA,57,30,27,1035.0,51,34,14,0.667,135,0.378,8,0.402,6.4,193,74,119,0.383,355,0.544,35,0.603,4.6,244,108,133,0.443,490,0.498,43,0.546,5.0,2015-16
420,1626169,Stanley Johnson,1610612765,DET,73,37,36,1687.0,58,33,19,0.569,210,0.276,9,0.289,6.9,248,44,203,0.177,407,0.609,23,0.646,6.4,306,77,222,0.252,617,0.496,32,0.523,6.5,2015-16
421,201939,Stephen Curry,1610612744,GSW,79,71,8,2700.0,68,26,42,0.382,273,0.249,5,0.254,13.1,362,57,309,0.157,651,0.556,46,0.598,9.3,430,83,351,0.193,924,0.465,51,0.493,9.9,2015-16
422,2581,Steve Blake,1610612765,DET,58,34,24,986.0,9,3,7,0.333,37,0.243,0,0.243,16.6,80,7,72,0.088,142,0.563,16,0.635,10.6,89,10,79,0.112,179,0.497,16,0.546,11.4,2015-16
423,200779,Steve Novak,1610612749,MIL,10,8,2,44.0,0,0,0,0.0,1,0.0,0,0.0,0.0,5,1,4,0.2,11,0.455,1,0.5,3.8,5,1,4,0.2,12,0.417,1,0.455,3.8,2015-16
424,203500,Steven Adams,1610612760,OKC,80,54,26,2014.0,219,152,53,0.694,524,0.418,20,0.435,4.9,314,109,203,0.347,720,0.436,81,0.491,4.4,533,261,256,0.49,1244,0.428,101,0.466,4.6,2015-16
425,204456,T.J. McConnell,1610612755,PHI,81,10,71,1606.0,43,10,32,0.233,121,0.355,4,0.368,16.7,207,32,174,0.155,358,0.578,27,0.625,8.3,250,42,206,0.168,479,0.522,31,0.558,9.7,2015-16
426,203933,T.J. Warren,1610612756,PHX,47,14,33,1070.0,57,28,28,0.491,170,0.335,5,0.345,9.9,90,23,69,0.256,157,0.573,15,0.634,9.0,147,51,97,0.347,327,0.45,20,0.479,9.4,2015-16
427,201959,Taj Gibson,1610612741,CHI,73,37,36,1936.0,206,141,58,0.684,444,0.464,12,0.477,5.8,298,101,193,0.339,550,0.542,55,0.602,5.6,504,242,251,0.48,994,0.507,67,0.544,5.7,2015-16
428,204028,Tarik Black,1610612747,LAL,39,6,33,496.0,44,29,14,0.659,123,0.358,5,0.373,6.1,113,36,75,0.319,181,0.624,15,0.681,4.4,157,65,89,0.414,304,0.516,20,0.553,4.9,2015-16
429,2419,Tayshaun Prince,1610612750,MIN,77,27,50,1462.0,32,15,16,0.469,90,0.356,3,0.368,10.3,115,29,88,0.252,226,0.509,28,0.581,8.1,147,44,104,0.299,316,0.465,31,0.516,8.5,2015-16
430,203093,Terrence Jones,1610612745,HOU,50,24,26,1044.0,62,38,21,0.613,174,0.356,6,0.369,6.8,149,64,85,0.43,274,0.544,22,0.591,5.2,211,102,106,0.483,448,0.471,28,0.502,5.7,2015-16
431,203082,Terrence Ross,1610612761,TOR,72,52,20,1731.0,21,4,17,0.19,69,0.304,0,0.304,18.0,164,15,147,0.091,301,0.545,24,0.592,6.5,185,19,164,0.103,370,0.5,24,0.535,8.0,2015-16
432,1626179,Terry Rozier,1610612738,BOS,38,23,15,308.0,24,12,11,0.5,54,0.444,2,0.462,11.5,39,14,25,0.359,77,0.506,6,0.549,7.5,63,26,36,0.413,131,0.481,8,0.512,9.0,2015-16
433,200757,Thabo Sefolosha,1610612737,ATL,75,42,33,1758.0,52,34,17,0.654,182,0.286,7,0.297,8.3,282,55,227,0.195,461,0.612,40,0.67,7.0,334,89,244,0.266,643,0.519,47,0.56,7.2,2015-16
434,201152,Thaddeus Young,1610612751,BKN,73,21,52,2407.0,176,110,66,0.625,465,0.378,20,0.396,6.9,484,137,341,0.283,729,0.664,59,0.722,5.0,660,247,407,0.374,1194,0.553,79,0.592,5.5,2015-16
435,203648,Thanasis Antetokounmpo,1610612752,NYK,2,1,1,6.0,0,0,0,0.0,0,0.0,0,0.0,0.0,1,0,1,0.0,2,0.5,0,0.5,5.8,1,0,1,0.0,2,0.5,0,0.5,5.8,2015-16
436,203080,Thomas Robinson,1610612751,BKN,71,16,55,916.0,136,110,22,0.809,304,0.447,8,0.459,4.7,223,75,148,0.336,342,0.652,27,0.708,4.0,359,185,170,0.515,646,0.556,35,0.588,4.2,2015-16
437,201168,Tiago Splitter,1610612737,ATL,36,21,15,579.0,45,33,11,0.733,125,0.36,2,0.366,5.2,75,33,39,0.44,173,0.434,19,0.487,4.4,120,66,50,0.55,298,0.403,21,0.433,4.7,2015-16
438,202353,Tibor Pleiss,1610612762,UTA,12,7,5,82.0,6,3,3,0.5,17,0.353,1,0.375,9.7,9,2,7,0.222,19,0.474,2,0.529,3.5,15,5,10,0.333,36,0.417,3,0.455,6.0,2015-16
439,1495,Tim Duncan,1610612759,SAS,61,50,11,1536.0,115,70,40,0.609,269,0.428,9,0.442,6.4,332,125,204,0.377,570,0.582,44,0.631,4.7,447,195,244,0.436,839,0.533,53,0.569,5.1,2015-16
440,204025,Tim Frazier,1610612740,NOP,51,25,26,741.0,26,20,6,0.769,80,0.325,2,0.333,8.1,84,13,70,0.155,166,0.506,15,0.556,8.4,110,33,76,0.3,246,0.447,17,0.48,8.3,2015-16
441,203501,Tim Hardaway Jr.,1610612737,ATL,51,29,22,864.0,7,2,5,0.286,41,0.171,0,0.171,13.9,79,19,62,0.241,150,0.527,13,0.577,7.0,86,21,67,0.244,191,0.45,13,0.483,7.5,2015-16
442,202389,Timofey Mozgov,1610612739,CLE,76,52,24,1326.0,110,77,32,0.7,300,0.367,5,0.373,6.0,227,94,129,0.414,451,0.503,41,0.554,5.0,337,171,161,0.507,751,0.449,46,0.478,5.3,2015-16
443,202699,Tobias Harris,1610612765,DET,75,37,38,2469.0,95,53,38,0.558,305,0.311,10,0.322,6.9,404,104,296,0.257,644,0.627,52,0.682,5.8,499,157,334,0.315,949,0.526,62,0.563,6.1,2015-16
444,201962,Toney Douglas,1610612740,NOP,61,22,39,1262.0,25,7,16,0.28,75,0.333,5,0.357,12.9,118,17,103,0.144,198,0.596,12,0.634,8.8,143,24,119,0.168,273,0.524,17,0.559,9.5,2015-16
445,2754,Tony Allen,1610612763,MEM,64,34,30,1620.0,104,66,35,0.635,304,0.342,9,0.353,7.5,192,38,152,0.198,286,0.671,30,0.75,7.9,296,104,187,0.351,590,0.502,39,0.537,7.8,2015-16
446,2225,Tony Parker,1610612759,SAS,72,59,13,1980.0,17,4,14,0.235,116,0.147,3,0.15,19.0,159,17,141,0.107,292,0.545,20,0.585,10.4,176,21,155,0.119,408,0.431,23,0.457,11.2,2015-16
447,203503,Tony Snell,1610612741,CHI,64,33,31,1301.0,19,6,13,0.316,58,0.328,5,0.358,13.6,180,31,147,0.172,297,0.606,24,0.659,7.7,199,37,160,0.186,355,0.561,29,0.61,8.2,2015-16
448,203100,Tony Wroten,1610612752,NYK,8,0,8,144.0,2,1,1,0.5,17,0.118,1,0.125,8.8,19,2,17,0.105,33,0.576,1,0.594,6.6,21,3,18,0.143,50,0.42,2,0.438,6.8,2015-16
449,2772,Trevor Ariza,1610612745,HOU,81,40,41,2859.0,67,33,34,0.493,241,0.278,6,0.285,12.1,299,65,235,0.217,506,0.591,39,0.64,7.9,366,98,269,0.268,747,0.49,45,0.521,8.6,2015-16
450,202344,Trevor Booker,1610612762,UTA,79,39,40,1632.0,166,111,52,0.669,411,0.404,9,0.413,6.1,286,97,187,0.339,477,0.6,43,0.659,4.6,452,208,239,0.46,888,0.509,52,0.541,5.2,2015-16
451,203504,Trey Burke,1610612762,UTA,64,31,33,1366.0,18,6,13,0.333,78,0.231,5,0.247,18.0,94,9,86,0.096,203,0.463,9,0.485,10.8,112,15,99,0.134,281,0.399,14,0.419,12.2,2015-16
452,1626168,Trey Lyles,1610612762,UTA,80,38,42,1382.0,59,38,20,0.644,182,0.324,7,0.337,8.6,240,61,178,0.254,402,0.597,40,0.663,4.8,299,99,198,0.331,584,0.512,47,0.557,5.5,2015-16
453,202684,Tristan Thompson,1610612739,CLE,82,57,25,2269.0,268,191,71,0.713,677,0.396,13,0.404,5.0,470,163,303,0.347,785,0.599,80,0.667,5.0,738,354,374,0.48,1462,0.505,93,0.539,5.0,2015-16
454,203584,Troy Daniels,1610612766,CHA,43,25,18,476.0,7,3,4,0.429,23,0.304,0,0.304,9.0,50,5,45,0.1,93,0.538,6,0.575,6.2,57,8,49,0.14,116,0.491,6,0.518,6.5,2015-16
455,201951,Ty Lawson,1610612754,IND,66,31,35,1411.0,26,7,20,0.269,102,0.255,5,0.268,15.2,94,9,89,0.096,197,0.477,14,0.514,10.4,120,16,109,0.133,299,0.401,19,0.429,11.5,2015-16
456,203898,Tyler Ennis,1610612749,MIL,46,17,29,654.0,13,7,5,0.538,47,0.277,0,0.277,8.4,62,6,57,0.097,114,0.544,5,0.569,9.8,75,13,62,0.173,161,0.466,5,0.481,9.6,2015-16
457,201946,Tyler Hansbrough,1610612766,CHA,44,28,16,343.0,40,28,10,0.7,82,0.488,1,0.494,4.9,49,22,26,0.449,95,0.516,16,0.62,5.6,89,50,36,0.562,177,0.503,17,0.556,5.3,2015-16
458,204020,Tyler Johnson,1610612748,MIA,36,19,17,863.0,28,13,15,0.464,83,0.337,5,0.359,9.7,81,13,68,0.16,194,0.418,19,0.463,7.9,109,26,83,0.239,277,0.394,24,0.431,8.4,2015-16
459,203092,Tyler Zeller,1610612738,BOS,59,37,22,698.0,62,42,18,0.677,167,0.371,3,0.378,5.3,113,52,61,0.46,223,0.507,21,0.559,4.5,175,94,79,0.537,390,0.449,24,0.478,4.8,2015-16
460,201936,Tyreke Evans,1610612740,NOP,25,11,14,765.0,20,10,10,0.5,86,0.233,4,0.244,9.5,109,15,94,0.138,172,0.634,13,0.686,8.1,129,25,104,0.194,258,0.5,17,0.535,8.3,2015-16
461,2199,Tyson Chandler,1610612756,PHX,66,18,48,1618.0,175,115,55,0.657,386,0.453,10,0.465,5.4,401,115,285,0.287,629,0.638,48,0.69,4.4,576,230,340,0.399,1015,0.567,58,0.602,4.7,2015-16
462,1626145,Tyus Jones,1610612750,MIN,37,13,24,573.0,7,1,6,0.143,27,0.259,3,0.292,12.8,40,5,36,0.125,80,0.5,5,0.533,8.5,47,6,42,0.128,107,0.439,8,0.475,9.1,2015-16
463,2617,Udonis Haslem,1610612748,MIA,37,25,12,260.0,10,5,5,0.5,21,0.476,1,0.5,8.0,65,20,45,0.308,87,0.747,5,0.793,3.5,75,25,50,0.333,108,0.694,6,0.735,4.2,2015-16
464,203506,Victor Oladipo,1610612753,ORL,71,32,39,2334.0,47,24,23,0.511,194,0.242,5,0.249,11.4,292,69,224,0.236,544,0.537,52,0.593,6.5,339,93,247,0.274,738,0.459,57,0.498,7.2,2015-16
465,1713,Vince Carter,1610612763,MEM,60,33,27,1005.0,31,20,10,0.645,97,0.32,3,0.33,7.3,115,31,83,0.27,221,0.52,20,0.572,6.9,146,51,93,0.349,318,0.459,23,0.495,7.0,2015-16
466,201961,Wayne Ellington,1610612751,BKN,76,18,58,1615.0,20,6,14,0.3,98,0.204,3,0.211,10.5,154,20,134,0.13,263,0.586,20,0.634,7.8,174,26,148,0.149,361,0.482,23,0.515,8.1,2015-16
467,202325,Wesley Johnson,1610612746,LAC,80,51,29,1666.0,37,16,21,0.432,102,0.363,5,0.381,12.8,211,56,153,0.265,440,0.48,39,0.526,6.3,248,72,174,0.29,542,0.458,44,0.498,7.2,2015-16
468,202083,Wesley Matthews,1610612742,DAL,78,40,38,2644.0,27,6,21,0.222,124,0.218,7,0.231,15.2,211,54,158,0.256,381,0.554,42,0.622,8.0,238,60,179,0.252,505,0.471,49,0.522,8.8,2015-16
469,203115,Will Barton,1610612743,DEN,82,33,49,2353.0,59,31,29,0.525,261,0.226,7,0.232,11.1,417,84,332,0.201,631,0.661,44,0.71,5.2,476,115,361,0.242,892,0.534,51,0.566,5.9,2015-16
470,1626161,Willie Cauley-Stein,1610612758,SAC,65,26,39,1394.0,133,86,43,0.647,264,0.504,9,0.522,5.7,214,76,141,0.355,355,0.603,41,0.682,5.8,347,162,184,0.467,619,0.561,50,0.61,5.7,2015-16
471,203186,Willie Reed,1610612751,BKN,39,8,31,426.0,49,32,13,0.653,106,0.462,2,0.471,4.9,73,33,38,0.452,129,0.566,12,0.624,4.5,122,65,51,0.533,235,0.519,14,0.552,4.6,2015-16
472,204098,Xavier Munford,1610612763,MEM,14,3,11,244.0,3,0,3,0.0,17,0.176,0,0.176,22.0,28,4,23,0.143,48,0.583,4,0.636,9.3,31,4,26,0.129,65,0.477,4,0.508,10.6,2015-16
473,203897,Zach LaVine,1610612750,MIN,82,29,53,2293.0,27,11,15,0.407,127,0.213,6,0.223,11.3,201,30,173,0.149,357,0.563,22,0.6,8.0,228,41,188,0.18,484,0.471,28,0.5,8.4,2015-16
474,2216,Zach Randolph,1610612763,MEM,68,37,31,2016.0,179,135,35,0.754,457,0.392,18,0.408,4.6,350,131,221,0.374,577,0.607,54,0.669,4.7,529,266,256,0.503,1034,0.512,72,0.55,4.7,2015-16
475,2585,Zaza Pachulia,1610612742,DAL,76,40,36,2004.0,249,185,55,0.743,558,0.446,6,0.451,5.4,469,175,292,0.373,782,0.6,75,0.663,4.2,718,360,347,0.501,1340,0.536,81,0.57,4.6,2015-16
0,1627773,AJ Hammons,1610612742,DAL,22,4,18,163.0,8,3,5,0.375,30,0.267,1,0.276,7.5,28,12,16,0.429,56,0.5,4,0.538,3.9,36,15,21,0.417,86,0.419,5,0.444,4.7,2016-17
1,201166,Aaron Brooks,1610612754,IND,64,36,28,870.0,18,5,13,0.278,67,0.269,3,0.281,13.2,51,6,47,0.118,113,0.451,5,0.472,9.9,69,11,60,0.159,180,0.383,8,0.401,10.8,2016-17
2,203932,Aaron Gordon,1610612753,ORL,80,29,51,2298.0,116,65,51,0.56,273,0.425,6,0.434,7.4,289,71,215,0.246,478,0.605,33,0.649,6.6,405,136,266,0.336,750,0.54,39,0.57,6.8,2016-17
3,1626151,Aaron Harrison,1610612766,CHA,5,2,3,17.0,0,0,0,0.0,1,0.0,0,0.0,0.0,3,0,3,0.0,3,1.0,0,1.0,5.5,3,0,3,0.0,4,0.75,0,0.75,5.5,2016-17
4,203940,Adreian Payne,1610612750,MIN,18,5,13,135.0,9,6,2,0.667,23,0.391,1,0.409,10.3,24,7,16,0.292,34,0.706,3,0.774,4.7,33,13,18,0.394,57,0.579,4,0.623,6.1,2016-17
5,201143,Al Horford,1610612738,BOS,68,46,22,2193.0,95,52,43,0.547,251,0.378,8,0.391,9.4,370,126,242,0.341,676,0.547,48,0.589,6.3,465,178,285,0.383,927,0.502,56,0.534,7.0,2016-17
6,2744,Al Jefferson,1610612754,IND,65,33,32,922.0,74,52,23,0.703,158,0.468,3,0.477,6.2,202,75,126,0.371,309,0.654,24,0.709,4.2,276,127,149,0.46,467,0.591,27,0.627,4.7,2016-17
7,202329,Al-Farouq Aminu,1610612757,POR,61,33,28,1773.0,77,42,31,0.545,196,0.393,4,0.401,7.2,374,121,249,0.324,637,0.587,57,0.645,5.5,451,163,280,0.361,829,0.544,61,0.587,5.8,2016-17
8,101187,Alan Anderson,1610612746,LAC,30,20,10,308.0,3,3,0,1.0,21,0.143,3,0.167,8.9,21,2,19,0.095,43,0.488,3,0.525,6.8,24,5,19,0.208,64,0.375,6,0.414,7.0,2016-17
9,1626210,Alan Williams,1610612756,PHX,47,11,36,708.0,94,63,25,0.67,215,0.437,4,0.445,6.1,198,76,119,0.384,306,0.647,19,0.69,4.2,292,139,144,0.476,521,0.56,23,0.586,4.8,2016-17
10,202692,Alec Burks,1610612762,UTA,42,26,16,653.0,17,9,8,0.529,56,0.304,2,0.315,9.2,103,26,77,0.252,168,0.613,13,0.665,6.2,120,35,85,0.292,224,0.536,15,0.574,6.6,2016-17
11,203518,Alex Abrines,1610612760,OKC,68,37,31,1055.0,18,8,10,0.444,54,0.333,3,0.353,10.6,68,17,50,0.25,155,0.439,15,0.486,8.1,86,25,60,0.291,209,0.411,18,0.45,8.6,2016-17
12,203458,Alex Len,1610612756,PHX,75,20,55,1528.0,155,101,45,0.652,363,0.427,10,0.439,5.6,348,122,223,0.351,587,0.593,50,0.648,4.4,503,223,268,0.443,949,0.53,60,0.566,4.7,2016-17
13,1627816,Alex Poythress,1610612755,PHI,6,0,6,157.0,11,7,3,0.636,25,0.44,0,0.44,4.8,18,8,9,0.444,42,0.429,4,0.474,7.2,29,15,12,0.517,67,0.433,4,0.46,6.3,2016-17
14,201582,Alexis Ajinca,1610612740,NOP,39,15,24,584.0,46,33,13,0.717,123,0.374,3,0.383,5.2,131,42,87,0.321,225,0.582,10,0.609,4.7,177,75,100,0.424,347,0.51,13,0.53,4.8,2016-17
15,203459,Allen Crabbe,1610612757,POR,79,39,40,2254.0,19,6,13,0.316,103,0.184,4,0.192,19.3,207,53,153,0.256,400,0.518,29,0.558,7.3,226,59,166,0.261,503,0.449,33,0.481,8.3,2016-17
16,202087,Alonzo Gee,1610612743,DEN,13,4,9,89.0,4,2,2,0.5,10,0.4,1,0.444,4.4,11,6,6,0.545,21,0.524,4,0.647,6.1,15,8,8,0.533,31,0.484,5,0.577,5.7,2016-17
17,101161,Amir Johnson,1610612738,BOS,80,51,29,1608.0,118,85,27,0.72,326,0.362,8,0.371,5.3,248,106,142,0.427,515,0.482,52,0.536,4.5,366,191,169,0.522,841,0.435,60,0.469,4.8,2016-17
18,2760,Anderson Varejao,1610612744,GSW,14,12,2,92.0,12,8,3,0.667,18,0.667,1,0.706,6.8,15,5,10,0.333,25,0.6,6,0.789,5.1,27,13,13,0.481,43,0.628,7,0.75,5.8,2016-17
19,203083,Andre Drummond,1610612765,DET,81,36,45,2409.0,345,269,71,0.78,646,0.534,12,0.544,5.1,770,280,488,0.364,1071,0.719,68,0.768,3.6,1115,549,559,0.492,1714,0.651,80,0.682,4.0,2016-17
20,2738,Andre Iguodala,1610612744,GSW,76,64,12,1998.0,51,22,28,0.431,106,0.481,7,0.515,10.2,253,63,187,0.249,456,0.555,33,0.598,9.3,304,85,215,0.28,562,0.541,40,0.582,9.4,2016-17
21,203460,Andre Roberson,1610612760,OKC,79,46,33,2376.0,98,60,35,0.612,313,0.313,7,0.32,7.2,305,76,226,0.249,566,0.539,42,0.582,6.0,403,136,261,0.337,877,0.46,49,0.487,6.3,2016-17
22,101106,Andrew Bogut,1610612739,CLE,27,8,19,583.0,56,38,17,0.679,113,0.496,3,0.509,6.2,162,59,102,0.364,262,0.618,27,0.689,4.0,218,97,119,0.445,372,0.586,30,0.637,4.6,2016-17
23,1626150,Andrew Harrison,1610612763,MEM,72,38,34,1474.0,23,6,17,0.261,104,0.221,1,0.223,17.9,113,16,96,0.142,235,0.481,21,0.528,9.6,136,22,113,0.162,339,0.401,22,0.429,11.0,2016-17
24,203094,Andrew Nicholson,1610612751,BKN,38,20,18,342.0,15,11,4,0.733,37,0.405,0,0.405,4.6,46,16,30,0.348,101,0.455,7,0.489,4.8,61,27,34,0.443,136,0.449,7,0.473,4.7,2016-17
25,203952,Andrew Wiggins,1610612750,MIN,82,31,51,3048.0,102,70,28,0.686,348,0.293,8,0.3,6.8,226,78,147,0.345,440,0.514,35,0.558,7.4,328,148,175,0.451,788,0.416,43,0.44,7.3,2016-17
26,203461,Anthony Bennett,1610612751,BKN,22,3,19,243.0,21,15,3,0.714,41,0.512,0,0.512,6.1,47,14,33,0.298,79,0.595,4,0.627,4.4,68,29,36,0.426,120,0.567,4,0.586,4.9,2016-17
27,1626148,Anthony Brown,1610612753,ORL,11,3,8,159.0,8,2,5,0.25,13,0.615,1,0.667,14.3,25,3,22,0.12,34,0.735,3,0.806,8.3,33,5,27,0.152,47,0.702,4,0.767,9.6,2016-17
28,203076,Anthony Davis,1610612740,NOP,75,31,44,2708.0,172,125,46,0.727,362,0.475,10,0.489,6.2,712,271,437,0.381,1053,0.676,61,0.718,4.8,884,396,483,0.448,1410,0.627,71,0.66,5.0,2016-17
29,201627,Anthony Morrow,1610612741,CHI,49,25,24,714.0,12,6,5,0.5,42,0.286,0,0.286,12.9,19,3,17,0.158,57,0.333,6,0.373,13.6,31,9,22,0.29,99,0.313,6,0.333,13.1,2016-17
30,201229,Anthony Tolliver,1610612758,SAC,65,26,39,1477.0,51,21,29,0.412,136,0.375,4,0.386,8.2,186,54,131,0.29,336,0.554,31,0.61,6.3,237,75,160,0.316,468,0.506,35,0.547,6.7,2016-17
31,203462,Archie Goodwin,1610612751,BKN,15,8,7,214.0,7,4,2,0.571,29,0.241,0,0.241,7.2,21,3,18,0.143,41,0.512,3,0.553,6.6,28,7,20,0.25,70,0.4,3,0.418,6.7,2016-17
32,202620,Arinze Onuaku,1610612753,ORL,8,3,5,28.0,2,2,0,1.0,4,0.5,0,0.5,2.3,4,3,1,0.75,10,0.4,0,0.4,2.2,6,5,1,0.833,14,0.429,0,0.429,2.2,2016-17
33,203382,Aron Baynes,1610612765,DET,75,34,41,1163.0,111,83,26,0.748,304,0.365,5,0.371,5.1,222,83,134,0.374,406,0.547,55,0.632,4.4,333,166,160,0.498,708,0.47,60,0.514,4.7,2016-17
34,201167,Arron Afflalo,1610612758,SAC,61,23,38,1580.0,9,3,6,0.333,82,0.11,3,0.114,11.8,116,9,107,0.078,224,0.518,14,0.552,8.7,125,12,113,0.096,306,0.408,17,0.433,9.1,2016-17
35,203085,Austin Rivers,1610612746,LAC,74,43,31,2054.0,20,10,10,0.5,138,0.145,6,0.152,9.9,141,22,119,0.156,345,0.409,38,0.459,9.0,161,32,129,0.199,483,0.333,44,0.367,9.1,2016-17
36,202340,Avery Bradley,1610612738,BOS,55,34,21,1835.0,65,30,32,0.462,220,0.295,2,0.298,8.8,269,48,221,0.178,484,0.556,46,0.614,5.9,334,78,253,0.234,704,0.474,48,0.509,6.4,2016-17
37,1626253,Axel Toupane,1610612740,NOP,4,2,2,47.0,0,0,0,0.0,0,0.0,0,0.0,0.0,1,0,1,0.0,6,0.167,0,0.167,14.6,1,0,1,0.0,6,0.167,0,0.167,14.6,2016-17
38,1627791,Ben Bentil,1610612742,DAL,3,2,1,10.0,0,0,0,0.0,0,0.0,0,0.0,0.0,2,1,1,0.5,3,0.667,0,0.667,6.9,2,1,1,0.5,3,0.667,0,0.667,6.9,2016-17
39,203463,Ben McLemore,1610612758,SAC,61,27,34,1176.0,19,9,11,0.474,108,0.176,4,0.183,8.6,110,18,89,0.164,219,0.502,28,0.576,6.5,129,27,100,0.209,326,0.396,32,0.439,6.9,2016-17
40,2757,Beno Udrih,1610612765,DET,39,18,21,560.0,6,1,5,0.167,38,0.158,0,0.158,21.5,51,7,44,0.137,91,0.56,8,0.614,8.9,57,8,49,0.14,129,0.442,8,0.471,10.2,2016-17
41,202687,Bismack Biyombo,1610612753,ORL,81,29,52,1793.0,157,104,48,0.662,363,0.433,6,0.44,6.2,410,131,279,0.32,689,0.595,58,0.65,4.4,567,235,327,0.414,1050,0.54,64,0.575,4.9,2016-17
42,201933,Blake Griffin,1610612746,LAC,61,40,21,2076.0,112,66,40,0.589,283,0.396,7,0.406,7.0,385,120,267,0.312,595,0.647,38,0.691,5.3,497,186,307,0.374,872,0.57,45,0.601,5.7,2016-17
43,1626246,Boban Marjanovic,1610612765,DET,35,16,19,293.0,46,38,7,0.826,89,0.517,4,0.541,4.1,84,26,58,0.31,112,0.75,6,0.792,4.7,130,64,65,0.492,200,0.65,10,0.684,4.4,2016-17
44,201628,Bobby Brown,1610612745,HOU,25,18,7,123.0,0,0,1,0.0,4,0.0,1,0.0,24.5,6,1,5,0.167,17,0.353,2,0.4,10.2,6,1,6,0.167,21,0.286,3,0.333,12.3,2016-17
45,1626171,Bobby Portis,1610612741,CHI,64,30,34,1000.0,75,44,31,0.587,164,0.457,3,0.466,6.8,221,69,148,0.312,349,0.633,27,0.686,5.2,296,113,179,0.382,513,0.577,30,0.613,5.6,2016-17
46,202711,Bojan Bogdanovic,1610612764,WAS,80,23,57,2064.0,37,21,15,0.568,181,0.204,7,0.213,10.0,240,43,198,0.179,435,0.552,34,0.599,6.6,277,64,213,0.231,616,0.45,41,0.482,7.0,2016-17
47,2564,Boris Diaw,1610612762,UTA,73,45,28,1283.0,46,32,16,0.696,115,0.4,5,0.418,6.9,112,27,84,0.241,267,0.419,29,0.471,5.9,158,59,100,0.373,382,0.414,34,0.454,6.3,2016-17
48,203078,Bradley Beal,1610612764,WAS,77,48,29,2684.0,53,19,35,0.358,210,0.252,12,0.268,14.7,187,39,148,0.209,397,0.471,27,0.505,9.3,240,58,183,0.242,606,0.396,39,0.423,10.6,2016-17
49,201148,Brandan Wright,1610612763,MEM,28,14,14,447.0,31,16,13,0.516,74,0.419,4,0.443,6.1,47,21,27,0.447,89,0.528,3,0.547,5.1,78,37,40,0.474,163,0.479,7,0.5,5.5,2016-17
50,101138,Brandon Bass,1610612746,LAC,52,29,23,577.0,43,31,12,0.721,104,0.413,0,0.413,6.0,86,28,58,0.326,141,0.61,6,0.637,5.2,129,59,70,0.457,245,0.527,6,0.54,5.5,2016-17
51,1627742,Brandon Ingram,1610612747,LAL,79,26,53,2279.0,60,26,34,0.433,204,0.294,10,0.309,9.1,256,59,198,0.23,428,0.598,29,0.642,6.5,316,85,232,0.269,628,0.503,39,0.537,7.0,2016-17
52,201943,Brandon Jennings,1610612764,WAS,81,37,44,1801.0,29,6,22,0.207,117,0.248,7,0.264,13.4,167,17,153,0.102,315,0.53,29,0.584,9.6,196,23,175,0.117,432,0.454,36,0.495,10.1,2016-17
53,202688,Brandon Knight,1610612756,PHX,53,16,37,1121.0,25,10,14,0.4,101,0.248,5,0.26,12.4,92,16,75,0.174,208,0.442,20,0.489,7.6,117,26,89,0.222,309,0.379,25,0.412,8.6,2016-17
54,201575,Brandon Rush,1610612750,MIN,47,15,32,1030.0,16,6,9,0.375,57,0.281,6,0.314,13.0,83,16,66,0.193,175,0.474,13,0.512,7.6,99,22,75,0.222,232,0.427,19,0.465,8.4,2016-17
55,203148,Brian Roberts,1610612766,CHA,41,16,25,416.0,5,3,2,0.6,28,0.179,1,0.185,10.1,34,4,30,0.118,60,0.567,5,0.618,9.6,39,7,32,0.179,88,0.443,6,0.476,9.6,2016-17
56,1627362,Briante Weber,1610612766,CHA,20,12,8,205.0,8,2,5,0.25,23,0.348,0,0.348,9.2,18,1,17,0.056,34,0.529,2,0.563,6.0,26,3,22,0.115,57,0.456,2,0.473,6.9,2016-17
57,1627744,Brice Johnson,1610612746,LAC,3,1,2,9.0,1,1,0,1.0,2,0.5,0,0.5,3.4,2,1,1,0.5,4,0.5,0,0.5,2.4,3,2,1,0.667,6,0.5,0,0.5,2.8,2016-17
58,201572,Brook Lopez,1610612751,BKN,75,20,55,2222.0,121,87,33,0.719,287,0.422,6,0.431,6.6,282,122,160,0.433,554,0.509,47,0.556,6.5,403,209,193,0.519,840,0.48,53,0.512,6.5,2016-17
59,203998,Bruno Caboclo,1610612761,TOR,8,7,1,38.0,4,3,1,0.75,5,0.8,0,0.8,3.1,5,2,3,0.4,7,0.714,1,0.833,3.7,9,5,4,0.556,12,0.75,1,0.818,3.4,2016-17
60,1627854,Bryn Forbes,1610612759,SAS,35,24,11,280.0,2,0,1,0.0,14,0.143,2,0.167,19.6,20,3,18,0.15,45,0.444,5,0.5,10.4,22,3,19,0.136,58,0.379,7,0.431,10.8,2016-17
61,1627741,Buddy Hield,1610612758,SAC,82,31,51,1888.0,35,10,24,0.286,152,0.23,6,0.24,11.2,234,29,206,0.124,424,0.552,33,0.598,7.8,269,39,230,0.145,576,0.467,39,0.501,8.3,2016-17
62,201228,C.J. Watson,1610612753,ORL,62,20,42,1012.0,16,1,15,0.063,67,0.239,5,0.258,16.5,73,11,62,0.151,144,0.507,17,0.575,9.2,89,12,77,0.135,211,0.422,22,0.471,10.5,2016-17
63,203912,C.J. Wilcox,1610612753,ORL,22,8,14,108.0,4,0,4,0.0,11,0.364,0,0.364,19.8,8,1,7,0.125,19,0.421,4,0.533,8.4,12,1,11,0.083,30,0.4,4,0.462,12.2,2016-17
64,203468,CJ McCollum,1610612757,POR,80,40,40,2796.0,60,19,43,0.317,236,0.254,8,0.263,14.2,229,34,198,0.148,496,0.462,36,0.498,9.3,289,53,241,0.183,730,0.396,44,0.421,10.3,2016-17
65,101139,CJ Miles,1610612754,IND,75,39,36,1756.0,28,12,16,0.429,93,0.301,4,0.315,13.0,197,43,155,0.218,313,0.629,20,0.672,8.2,225,55,171,0.244,406,0.554,24,0.589,8.8,2016-17
66,1626166,Cameron Payne,1610612741,CHI,31,16,15,462.0,3,1,2,0.333,36,0.083,0,0.083,8.9,45,2,44,0.044,83,0.542,5,0.577,8.4,48,3,46,0.063,119,0.403,5,0.421,8.4,2016-17
67,1627747,Caris LeVert,1610612751,BKN,56,15,41,1218.0,23,9,12,0.391,88,0.261,4,0.274,13.7,164,23,141,0.14,255,0.643,16,0.686,7.1,187,32,153,0.171,343,0.545,20,0.579,7.8,2016-17
68,2546,Carmelo Anthony,1610612752,NYK,74,29,45,2538.0,62,42,20,0.677,245,0.253,3,0.256,7.7,376,91,284,0.242,615,0.611,36,0.649,6.3,438,133,304,0.304,859,0.51,39,0.534,6.5,2016-17
69,202718,Chandler Parsons,1610612763,MEM,34,18,16,675.0,6,3,4,0.5,38,0.158,1,0.162,7.4,78,16,64,0.205,124,0.629,9,0.678,7.7,84,19,68,0.226,162,0.519,10,0.553,7.8,2016-17
70,101112,Channing Frye,1610612739,CLE,74,44,30,1398.0,37,21,16,0.568,107,0.346,3,0.356,9.5,253,99,152,0.391,458,0.552,40,0.605,5.1,290,120,168,0.414,564,0.514,43,0.557,5.6,2016-17
71,1626184,Chasson Randle,1610612752,NYK,26,8,18,299.0,6,3,3,0.5,25,0.24,2,0.261,11.9,26,5,21,0.192,48,0.542,5,0.605,11.2,32,8,24,0.25,73,0.438,7,0.485,11.3,2016-17
72,1627767,Cheick Diallo,1610612740,NOP,17,9,8,199.0,23,15,9,0.652,44,0.523,0,0.523,6.3,50,12,38,0.24,72,0.694,4,0.735,5.0,73,27,47,0.37,116,0.629,4,0.652,5.4,2016-17
73,1627778,Chinanu Onuaku,1610612745,HOU,5,2,3,52.0,2,0,2,0.0,10,0.2,0,0.2,5.5,8,4,4,0.5,15,0.533,0,0.533,5.7,10,4,6,0.4,25,0.4,0,0.4,5.7,2016-17
74,2365,Chris Andersen,1610612739,CLE,12,8,4,114.0,9,8,1,0.889,26,0.346,0,0.346,7.0,22,6,16,0.273,51,0.431,5,0.478,4.3,31,14,17,0.452,77,0.403,5,0.431,5.1,2016-17
75,1626191,Chris McCullough,1610612764,WAS,16,1,15,80.0,9,4,5,0.444,18,0.5,0,0.5,7.5,10,1,9,0.1,22,0.455,2,0.5,4.0,19,5,14,0.263,40,0.475,2,0.5,5.7,2016-17
76,101108,Chris Paul,1610612746,LAC,61,43,18,1921.0,40,17,25,0.425,136,0.294,6,0.308,15.7,264,32,234,0.121,498,0.53,29,0.563,8.0,304,49,259,0.161,634,0.479,35,0.508,9.1,2016-17
77,1626174,Christian Wood,1610612766,CHA,13,5,8,107.0,14,11,3,0.786,24,0.583,0,0.583,4.0,15,3,12,0.2,36,0.417,5,0.484,5.1,29,14,15,0.483,60,0.483,5,0.527,4.6,2016-17
78,203991,Clint Capela,1610612745,HOU,65,44,21,1551.0,178,125,48,0.702,400,0.445,11,0.458,6.2,348,134,212,0.385,584,0.596,34,0.633,4.7,526,259,260,0.492,983,0.535,45,0.561,5.2,2016-17
79,203469,Cody Zeller,1610612766,CHA,62,33,29,1725.0,135,84,52,0.622,358,0.377,8,0.386,5.8,270,107,164,0.396,537,0.503,48,0.552,5.6,405,191,216,0.472,895,0.453,56,0.483,5.7,2016-17
80,202332,Cole Aldrich,1610612750,MIN,62,23,39,531.0,51,29,21,0.569,105,0.486,2,0.495,7.4,107,43,61,0.402,177,0.605,11,0.645,4.6,158,72,82,0.456,281,0.562,13,0.59,5.5,2016-17
81,201147,Corey Brewer,1610612747,LAL,82,47,35,1281.0,32,9,22,0.281,140,0.229,1,0.23,10.2,134,26,105,0.194,239,0.561,21,0.615,8.2,166,35,127,0.211,379,0.438,22,0.465,8.6,2016-17
82,202709,Cory Joseph,1610612761,TOR,79,48,31,1977.0,50,26,25,0.52,211,0.237,7,0.245,10.6,178,45,135,0.253,412,0.432,46,0.486,7.8,228,71,160,0.311,623,0.366,53,0.4,8.5,2016-17
83,201584,Courtney Lee,1610612752,NYK,77,29,48,2459.0,53,15,40,0.283,154,0.344,5,0.356,12.9,206,19,185,0.092,388,0.531,35,0.584,10.1,259,34,225,0.131,542,0.478,40,0.516,10.7,2016-17
84,1626245,Cristiano Felicio,1610612741,CHI,66,31,35,1040.0,124,85,35,0.685,315,0.394,4,0.399,5.3,187,56,131,0.299,371,0.504,38,0.562,4.1,311,141,166,0.453,686,0.453,42,0.483,4.6,2016-17
85,1626156,D'Angelo Russell,1610612747,LAL,63,21,42,1811.0,31,11,21,0.355,164,0.189,6,0.196,12.7,190,20,175,0.105,352,0.54,23,0.578,8.7,221,31,196,0.14,516,0.428,29,0.454,9.4,2016-17
86,201571,D.J. Augustin,1610612753,ORL,78,29,49,1538.0,15,4,11,0.267,86,0.174,4,0.183,14.3,102,7,96,0.069,203,0.502,10,0.528,11.3,117,11,107,0.094,289,0.405,14,0.425,11.7,2016-17
87,2563,Dahntay Jones,1610612739,CLE,1,0,1,12.0,1,1,0,1.0,2,0.5,0,0.5,4.2,1,0,1,0.0,2,0.5,0,0.5,4.3,2,1,1,0.5,4,0.5,0,0.5,4.3,2016-17
88,1627745,Damian Jones,1610612744,GSW,10,7,3,85.0,9,4,5,0.444,23,0.391,1,0.409,6.4,14,4,10,0.286,23,0.609,1,0.636,5.3,23,8,15,0.348,46,0.5,2,0.523,5.7,2016-17
89,203081,Damian Lillard,1610612757,POR,75,38,37,2693.0,46,22,22,0.478,225,0.204,11,0.215,10.7,322,54,271,0.168,606,0.531,54,0.583,8.7,368,76,293,0.207,831,0.443,65,0.48,8.9,2016-17
90,204014,Damjan Rudez,1610612753,ORL,45,12,33,314.0,5,2,2,0.4,10,0.5,0,0.5,13.0,20,3,16,0.15,42,0.476,5,0.541,8.0,25,5,18,0.2,52,0.481,5,0.532,8.9,2016-17
91,1627849,Daniel Ochefu,1610612764,WAS,19,12,7,75.0,5,2,3,0.4,23,0.217,0,0.217,5.9,17,7,10,0.412,20,0.85,1,0.895,4.3,22,9,13,0.409,43,0.512,1,0.524,4.6,2016-17
92,201568,Danilo Gallinari,1610612743,DEN,62,30,32,2104.0,39,21,18,0.538,153,0.255,5,0.264,9.7,284,57,227,0.201,470,0.604,38,0.657,7.6,323,78,245,0.241,622,0.519,43,0.558,7.9,2016-17
93,201980,Danny Green,1610612759,SAS,67,51,16,1778.0,31,13,17,0.419,98,0.316,1,0.32,12.4,191,48,145,0.251,407,0.469,38,0.518,6.2,222,61,162,0.275,505,0.44,39,0.476,7.1,2016-17
94,201967,Dante Cunningham,1610612740,NOP,66,28,38,1649.0,56,31,23,0.554,126,0.444,3,0.455,7.1,221,45,175,0.204,391,0.565,29,0.61,5.7,277,76,198,0.274,516,0.537,32,0.572,6.0,2016-17
95,203957,Dante Exum,1610612762,UTA,66,40,26,1228.0,30,9,20,0.3,90,0.333,1,0.337,15.6,102,16,86,0.157,197,0.518,12,0.551,8.5,132,25,106,0.189,287,0.46,13,0.482,10.1,2016-17
96,1627863,Danuel House Jr.,1610612764,WAS,1,0,1,1.0,0,0,0,0.0,0,0.0,0,0.0,0.0,1,0,1,0.0,1,1.0,0,1.0,5.0,1,0,1,0.0,1,1.0,0,1.0,5.0,2016-17
97,203967,Dario Saric,1610612755,PHI,81,28,53,2129.0,112,70,32,0.625,315,0.356,8,0.365,7.1,401,118,277,0.294,683,0.587,54,0.638,4.8,513,188,309,0.366,997,0.515,62,0.549,5.3,2016-17
98,201589,Darrell Arthur,1610612743,DEN,41,20,21,639.0,25,18,7,0.72,60,0.417,4,0.446,8.4,87,25,59,0.287,166,0.524,15,0.576,6.7,112,43,66,0.384,226,0.496,19,0.541,7.1,2016-17
99,201954,Darren Collison,1610612758,SAC,68,26,42,2063.0,23,8,15,0.348,130,0.177,5,0.184,16.1,129,11,119,0.085,260,0.496,23,0.544,11.4,152,19,134,0.125,390,0.39,28,0.42,12.1,2016-17
100,1626199,Darrun Hilliard,1610612765,DET,39,19,20,381.0,2,1,1,0.5,22,0.091,2,0.1,13.5,31,6,25,0.194,56,0.554,6,0.62,9.1,33,7,26,0.212,77,0.429,8,0.478,9.4,2016-17
101,101135,David Lee,1610612759,SAS,78,58,20,1464.0,148,98,48,0.662,326,0.454,10,0.468,6.1,290,96,193,0.331,503,0.577,40,0.626,4.8,438,194,241,0.443,826,0.53,50,0.564,5.2,2016-17
102,1628021,David Nwaba,1610612747,LAL,20,5,15,397.0,17,9,9,0.529,62,0.274,2,0.283,5.2,46,10,36,0.217,86,0.535,11,0.613,7.8,63,19,45,0.302,148,0.426,13,0.467,7.3,2016-17
103,2561,David West,1610612744,GSW,68,56,12,854.0,47,29,18,0.617,102,0.461,3,0.475,5.2,156,75,78,0.481,307,0.508,28,0.559,5.1,203,104,96,0.512,409,0.496,31,0.537,5.1,2016-17
104,202722,Davis Bertans,1610612759,SAS,66,51,15,803.0,22,13,9,0.591,60,0.367,2,0.379,10.3,76,27,48,0.355,185,0.411,20,0.461,6.1,98,40,57,0.408,245,0.4,22,0.439,7.1,2016-17
105,201599,DeAndre Jordan,1610612746,LAC,81,51,30,2570.0,298,207,84,0.695,570,0.523,10,0.532,4.9,816,254,558,0.311,1133,0.72,57,0.758,4.5,1114,461,642,0.414,1700,0.655,67,0.682,4.6,2016-17
106,202732,DeAndre Liggins,1610612742,DAL,62,40,22,777.0,20,7,11,0.35,63,0.317,3,0.333,12.9,88,14,73,0.159,155,0.568,9,0.603,7.9,108,21,84,0.194,217,0.498,12,0.527,8.8,2016-17
107,1627761,DeAndre' Bembry,1610612737,ATL,38,20,18,371.0,14,9,5,0.643,47,0.298,0,0.298,8.1,45,10,35,0.222,90,0.5,14,0.592,7.5,59,19,40,0.322,136,0.434,14,0.484,7.7,2016-17
108,201942,DeMar DeRozan,1610612761,TOR,73,46,27,2591.0,70,34,34,0.486,248,0.282,9,0.293,11.1,315,62,251,0.197,504,0.625,27,0.66,7.9,385,96,285,0.249,751,0.513,36,0.538,8.5,2016-17
109,202326,DeMarcus Cousins,1610612740,NOP,72,30,42,2465.0,152,111,30,0.73,436,0.349,10,0.357,5.5,642,194,440,0.302,894,0.718,51,0.762,4.5,794,305,470,0.384,1322,0.601,61,0.63,4.7,2016-17
110,201960,DeMarre Carroll,1610612761,TOR,71,43,28,1860.0,62,36,23,0.581,209,0.297,12,0.315,8.4,210,48,161,0.229,412,0.51,37,0.56,7.1,272,84,184,0.309,619,0.439,49,0.477,7.4,2016-17
111,1627749,Dejounte Murray,1610612759,SAS,38,29,9,321.0,6,3,3,0.5,30,0.2,2,0.214,15.0,36,9,27,0.25,81,0.444,9,0.5,6.6,42,12,30,0.286,111,0.378,11,0.42,7.8,2016-17
112,1626153,Delon Wright,1610612761,TOR,27,19,8,446.0,16,4,12,0.25,53,0.302,1,0.308,9.4,32,10,22,0.313,68,0.471,6,0.516,9.0,48,14,34,0.292,121,0.397,7,0.421,9.1,2016-17
113,1627743,Demetrius Jackson,1610612738,BOS,5,1,4,17.0,2,1,1,0.5,3,0.667,0,0.667,17.9,2,0,2,0.0,5,0.4,0,0.4,14.0,4,1,3,0.25,8,0.5,0,0.5,15.9,2016-17
114,203471,Dennis Schroder,1610612737,ATL,79,42,37,2485.0,42,15,27,0.357,243,0.173,12,0.182,13.7,206,26,181,0.126,416,0.495,46,0.557,10.8,248,41,208,0.165,659,0.376,58,0.413,11.4,2016-17
115,1627756,Denzel Valentine,1610612741,CHI,57,28,29,977.0,11,2,9,0.182,50,0.22,1,0.224,17.0,140,32,106,0.229,259,0.541,24,0.596,7.0,151,34,115,0.225,309,0.489,25,0.532,7.8,2016-17
116,101114,Deron Williams,1610612739,CLE,63,24,39,1625.0,13,6,8,0.462,87,0.149,4,0.157,18.6,132,13,119,0.098,263,0.502,22,0.548,10.1,145,19,127,0.131,350,0.414,26,0.448,11.0,2016-17
117,202324,Derrick Favors,1610612762,UTA,50,33,17,1186.0,92,61,29,0.663,218,0.422,8,0.438,5.4,213,81,130,0.38,378,0.563,37,0.625,4.6,305,142,159,0.466,593,0.514,45,0.557,4.9,2016-17
118,1627884,Derrick Jones Jr.,1610612756,PHX,32,7,25,545.0,39,24,14,0.615,71,0.549,0,0.549,7.6,40,12,28,0.3,85,0.471,6,0.506,6.7,79,36,42,0.456,156,0.506,6,0.527,7.1,2016-17
119,201565,Derrick Rose,1610612752,NYK,64,26,38,2082.0,66,29,36,0.439,257,0.257,22,0.281,11.0,180,23,157,0.128,338,0.533,25,0.575,10.4,246,52,193,0.211,595,0.413,47,0.449,10.6,2016-17
120,202682,Derrick Williams,1610612739,CLE,50,16,34,804.0,19,14,6,0.737,50,0.38,1,0.388,6.4,111,20,92,0.18,176,0.631,16,0.694,5.4,130,34,98,0.262,226,0.575,17,0.622,5.6,2016-17
121,1626164,Devin Booker,1610612756,PHX,76,23,53,2656.0,44,19,26,0.432,228,0.193,8,0.2,12.4,202,33,171,0.163,420,0.481,36,0.526,9.0,246,52,197,0.211,648,0.38,44,0.407,9.6,2016-17
122,2734,Devin Harris,1610612742,DAL,64,28,36,1071.0,11,3,7,0.273,68,0.162,6,0.177,9.3,115,19,96,0.165,211,0.545,20,0.602,8.2,126,22,103,0.175,279,0.452,26,0.498,8.5,2016-17
123,203473,Dewayne Dedmon,1610612759,SAS,75,55,20,1316.0,128,91,35,0.711,300,0.427,6,0.435,5.8,365,118,246,0.323,513,0.712,27,0.751,4.5,493,209,281,0.424,810,0.609,33,0.634,4.9,2016-17
124,1627738,Deyonta Davis,1610612763,MEM,36,23,13,238.0,20,12,8,0.6,52,0.385,2,0.4,5.2,40,17,23,0.425,73,0.548,3,0.571,5.8,60,29,31,0.483,125,0.48,5,0.5,5.6,2016-17
125,1627754,Diamond Stone,1610612746,LAC,7,6,1,24.0,1,0,1,0.0,12,0.083,1,0.091,9.5,5,1,4,0.2,10,0.5,0,0.5,5.6,6,1,5,0.167,21,0.286,1,0.3,6.2,2016-17
126,203079,Dion Waiters,1610612748,MIA,46,27,19,1384.0,18,8,10,0.444,118,0.153,7,0.162,11.4,135,25,112,0.185,285,0.474,23,0.515,8.9,153,33,122,0.216,401,0.382,30,0.412,9.2,2016-17
127,1717,Dirk Nowitzki,1610612742,DAL,53,22,31,1394.0,23,11,11,0.478,66,0.348,6,0.383,10.4,324,120,202,0.37,478,0.678,34,0.73,4.4,347,131,213,0.378,542,0.64,40,0.691,4.8,2016-17
128,1627734,Domantas Sabonis,1610612760,OKC,81,46,35,1631.0,46,27,17,0.587,170,0.271,8,0.284,7.4,242,87,154,0.36,442,0.548,31,0.589,5.5,288,114,171,0.396,610,0.472,39,0.504,5.8,2016-17
129,202700,Donatas Motiejunas,1610612740,NOP,34,16,18,479.0,26,15,11,0.577,64,0.406,0,0.406,6.8,75,29,47,0.387,142,0.528,10,0.568,4.8,101,44,58,0.436,206,0.49,10,0.515,5.3,2016-17
130,1627827,Dorian Finney-Smith,1610612742,DAL,80,32,48,1632.0,54,31,22,0.574,149,0.362,7,0.38,9.4,167,50,116,0.299,320,0.522,16,0.549,6.2,221,81,138,0.367,468,0.472,23,0.497,6.9,2016-17
131,203926,Doug McDermott,1610612760,OKC,66,35,31,1508.0,20,10,11,0.5,98,0.204,6,0.217,14.4,159,49,111,0.308,305,0.521,44,0.609,5.2,179,59,122,0.33,403,0.444,50,0.507,6.3,2016-17
132,1627733,Dragan Bender,1610612756,PHX,41,12,29,545.0,22,11,10,0.5,46,0.478,3,0.512,9.3,74,21,53,0.284,138,0.536,5,0.556,5.4,96,32,63,0.333,182,0.527,8,0.552,6.2,2016-17
133,203110,Draymond Green,1610612744,GSW,76,62,14,2471.0,98,61,36,0.622,252,0.389,13,0.41,6.5,501,171,326,0.341,835,0.6,66,0.651,4.6,599,232,362,0.387,1082,0.554,79,0.597,4.9,2016-17
134,2730,Dwight Howard,1610612737,ATL,74,37,37,2199.0,296,211,76,0.713,650,0.455,7,0.46,4.2,644,223,416,0.346,1003,0.642,60,0.683,4.0,940,434,492,0.462,1652,0.569,67,0.593,4.0,2016-17
135,203939,Dwight Powell,1610612742,DAL,76,29,47,1318.0,90,50,39,0.556,252,0.357,9,0.37,7.1,211,58,151,0.275,353,0.598,35,0.664,4.8,301,108,190,0.359,605,0.498,44,0.537,5.4,2016-17
136,2548,Dwyane Wade,1610612741,CHI,60,29,31,1792.0,63,32,29,0.508,189,0.333,8,0.348,7.3,207,40,165,0.193,362,0.572,24,0.612,6.5,270,72,194,0.267,551,0.49,32,0.52,6.7,2016-17
137,202734,E'Twaun Moore,1610612740,NOP,73,32,41,1820.0,33,12,19,0.364,91,0.363,1,0.367,11.9,119,24,93,0.202,257,0.463,26,0.515,9.9,152,36,112,0.237,348,0.437,27,0.474,10.4,2016-17
138,202334,Ed Davis,1610612757,POR,46,19,27,789.0,96,68,25,0.708,242,0.397,10,0.414,4.9,148,55,92,0.372,286,0.517,25,0.567,4.9,244,123,117,0.504,528,0.462,35,0.495,4.9,2016-17
139,204002,Edy Tavares,1610612739,CLE,2,1,1,28.0,4,2,2,0.5,8,0.5,0,0.5,9.4,7,6,1,0.857,12,0.583,0,0.583,4.3,11,8,3,0.727,20,0.55,0,0.55,6.1,2016-17
140,203901,Elfrid Payton,1610612753,ORL,82,29,53,2412.0,89,41,47,0.461,319,0.279,16,0.294,9.4,298,35,265,0.117,509,0.585,46,0.644,8.7,387,76,312,0.196,828,0.467,62,0.505,8.9,2016-17
141,202407,Elijah Millsap,1610612756,PHX,2,1,1,23.0,3,1,2,0.333,4,0.75,0,0.75,11.3,3,0,3,0.0,11,0.273,2,0.333,5.0,6,1,5,0.167,15,0.4,2,0.462,8.2,2016-17
142,1626144,Emmanuel Mudiay,1610612743,DEN,54,24,30,1384.0,29,9,20,0.31,145,0.2,9,0.213,13.0,147,17,131,0.116,262,0.561,21,0.61,8.6,176,26,151,0.148,407,0.432,30,0.467,9.3,2016-17
143,202683,Enes Kanter,1610612760,OKC,72,43,29,1533.0,195,149,38,0.764,494,0.395,14,0.406,4.2,287,92,193,0.321,508,0.565,49,0.625,4.6,482,241,231,0.5,1000,0.482,63,0.514,4.4,2016-17
144,202339,Eric Bledsoe,1610612756,PHX,64,21,43,2110.0,49,27,21,0.551,230,0.213,15,0.228,10.4,259,41,218,0.158,444,0.583,35,0.633,8.5,308,68,239,0.221,673,0.458,50,0.494,8.8,2016-17
145,201569,Eric Gordon,1610612745,HOU,75,50,25,2323.0,29,8,21,0.276,186,0.156,4,0.159,16.5,172,32,140,0.186,397,0.433,31,0.47,9.3,201,40,161,0.199,583,0.345,35,0.367,10.4,2016-17
146,101141,Ersan Ilyasova,1610612737,ATL,82,35,47,2142.0,115,84,30,0.73,329,0.35,7,0.357,6.3,366,114,249,0.311,609,0.601,49,0.654,5.5,481,198,279,0.412,938,0.513,56,0.545,5.7,2016-17
147,203095,Evan Fournier,1610612753,ORL,68,23,45,2234.0,44,20,22,0.455,192,0.229,4,0.234,11.7,165,36,127,0.218,359,0.46,44,0.524,8.5,209,56,149,0.268,549,0.381,48,0.417,9.1,2016-17
148,202323,Evan Turner,1610612757,POR,65,34,31,1659.0,36,18,18,0.5,150,0.24,0,0.24,9.7,211,42,166,0.199,405,0.521,44,0.584,6.6,247,60,184,0.243,555,0.445,44,0.483,7.1,2016-17
149,1626163,Frank Kaminsky,1610612766,CHA,75,31,44,1954.0,57,36,21,0.632,182,0.313,10,0.331,8.5,279,81,198,0.29,527,0.529,49,0.584,5.8,336,117,219,0.348,708,0.475,59,0.518,6.3,2016-17
150,1627832,Fred VanVleet,1610612761,TOR,36,24,12,292.0,4,1,4,0.25,27,0.148,1,0.154,17.2,38,4,34,0.105,59,0.644,2,0.667,8.7,42,5,38,0.119,85,0.494,3,0.512,9.6,2016-17
151,202066,Garrett Temple,1610612758,SAC,65,25,40,1728.0,32,11,21,0.344,131,0.244,4,0.252,12.3,152,45,106,0.296,297,0.512,18,0.545,9.1,184,56,127,0.304,428,0.43,22,0.453,9.7,2016-17
152,203914,Gary Harris,1610612743,DEN,56,28,28,1748.0,48,24,24,0.5,155,0.31,8,0.327,10.2,125,22,103,0.176,235,0.532,22,0.587,9.0,173,46,127,0.266,390,0.444,30,0.481,9.3,2016-17
153,202390,Gary Neal,1610612737,ATL,2,1,1,18.0,0,0,0,0.0,0,0.0,0,0.0,0.0,1,0,1,0.0,2,0.5,0,0.5,9.8,1,0,1,0.0,2,0.5,0,0.5,9.8,2016-17
154,1627780,Gary Payton II,1610612749,MIL,6,2,4,99.0,0,0,0,0.0,7,0.0,2,0.0,0.0,12,1,11,0.083,22,0.545,1,0.571,8.0,12,1,11,0.083,29,0.414,3,0.462,8.0,2016-17
155,201588,George Hill,1610612762,UTA,49,33,16,1544.0,23,10,14,0.435,87,0.264,1,0.267,12.1,144,33,116,0.229,290,0.497,30,0.554,7.8,167,43,130,0.257,377,0.443,31,0.483,8.4,2016-17
156,1627777,Georges Niang,1610612754,IND,22,11,11,90.0,2,0,2,0.0,12,0.167,1,0.182,9.6,15,3,12,0.2,29,0.517,5,0.625,7.7,17,3,14,0.176,41,0.415,6,0.486,7.9,2016-17
157,1627834,Georgios Papagiannis,1610612758,SAC,22,7,15,355.0,24,14,7,0.583,42,0.571,0,0.571,4.9,62,20,42,0.323,102,0.608,11,0.681,4.3,86,34,49,0.395,144,0.597,11,0.647,4.5,2016-17
158,101123,Gerald Green,1610612738,BOS,47,32,15,538.0,16,8,8,0.5,53,0.302,4,0.327,13.9,68,9,58,0.132,120,0.567,11,0.624,7.3,84,17,66,0.202,173,0.486,15,0.532,8.5,2016-17
159,201945,Gerald Henderson,1610612755,PHI,72,24,48,1667.0,34,13,22,0.382,134,0.254,4,0.262,13.2,151,28,120,0.185,266,0.568,12,0.594,8.8,185,41,142,0.222,400,0.463,16,0.482,9.7,2016-17
160,203507,Giannis Antetokounmpo,1610612749,MIL,80,42,38,2845.0,142,101,39,0.711,390,0.364,11,0.375,6.4,558,137,415,0.246,849,0.657,59,0.706,6.4,700,238,454,0.34,1238,0.565,70,0.599,6.4,2016-17
161,203922,Glenn Robinson III,1610612754,IND,68,35,33,1399.0,53,22,32,0.415,155,0.342,1,0.344,10.8,189,36,154,0.19,350,0.54,35,0.6,6.8,242,58,186,0.24,505,0.479,36,0.516,7.7,2016-17
162,201609,Goran Dragic,1610612748,MIA,73,40,33,2459.0,62,20,40,0.323,282,0.22,8,0.226,12.3,217,32,188,0.147,469,0.463,40,0.506,8.9,279,52,228,0.186,750,0.372,48,0.397,9.6,2016-17
163,202330,Gordon Hayward,1610612762,UTA,73,46,27,2516.0,49,26,25,0.531,180,0.272,5,0.28,11.9,345,56,286,0.162,542,0.637,40,0.687,7.2,394,82,311,0.208,722,0.546,45,0.582,7.8,2016-17
164,203476,Gorgui Dieng,1610612750,MIN,82,31,51,2653.0,188,113,72,0.601,454,0.414,12,0.425,7.1,459,134,323,0.292,792,0.58,72,0.638,5.1,647,247,395,0.382,1242,0.521,84,0.559,5.6,2016-17
165,202328,Greg Monroe,1610612749,MIL,81,42,39,1823.0,167,134,31,0.802,418,0.4,10,0.409,4.9,365,134,231,0.367,590,0.619,52,0.678,4.8,532,268,262,0.504,1007,0.528,62,0.563,4.9,2016-17
166,202349,Greivis Vasquez,1610612751,BKN,3,1,2,39.0,0,0,1,0.0,2,0.0,0,0.0,0.0,2,0,2,0.0,5,0.4,1,0.5,6.5,2,0,3,0.0,7,0.286,1,0.333,6.5,2016-17
167,203084,Harrison Barnes,1610612742,DAL,78,31,47,2767.0,92,47,44,0.511,257,0.358,11,0.374,8.7,298,88,209,0.295,574,0.519,53,0.572,6.5,390,135,253,0.346,829,0.47,64,0.51,7.0,2016-17
168,202355,Hassan Whiteside,1610612748,MIA,77,39,38,2513.0,293,221,64,0.754,665,0.441,19,0.454,4.6,795,304,483,0.382,1187,0.67,73,0.714,3.6,1088,525,547,0.483,1850,0.588,92,0.619,3.8,2016-17
169,1627740,Henry Ellenson,1610612765,DET,19,8,11,146.0,8,4,4,0.5,16,0.5,0,0.5,3.9,33,6,27,0.182,48,0.688,4,0.75,4.8,41,10,31,0.244,64,0.641,4,0.683,4.6,2016-17
170,203138,Hollis Thompson,1610612740,NOP,40,12,28,752.0,19,8,9,0.421,52,0.365,1,0.373,12.3,93,18,73,0.194,159,0.585,12,0.633,7.0,112,26,82,0.232,211,0.531,13,0.566,7.8,2016-17
171,203546,Ian Clark,1610612744,GSW,77,63,14,1137.0,22,5,17,0.227,90,0.244,4,0.256,13.4,99,11,90,0.111,185,0.535,22,0.607,9.5,121,16,107,0.132,275,0.44,26,0.486,10.3,2016-17
172,101133,Ian Mahinmi,1610612764,WAS,31,19,12,555.0,47,24,23,0.511,120,0.392,4,0.405,6.7,103,34,66,0.33,177,0.582,22,0.665,5.1,150,58,89,0.387,297,0.505,26,0.554,5.6,2016-17
173,202697,Iman Shumpert,1610612739,CLE,76,48,28,1937.0,39,13,26,0.333,119,0.328,6,0.345,13.5,179,34,146,0.19,333,0.538,25,0.581,7.8,218,47,172,0.216,452,0.482,31,0.518,8.8,2016-17
174,203477,Isaiah Canaan,1610612741,CHI,39,19,20,592.0,6,2,4,0.333,36,0.167,3,0.182,9.0,44,5,39,0.114,84,0.524,7,0.571,8.7,50,7,43,0.14,120,0.417,10,0.455,8.8,2016-17
175,1627819,Isaiah Taylor,1610612745,HOU,4,3,1,52.0,1,1,0,1.0,3,0.333,0,0.333,11.3,2,0,2,0.0,4,0.5,0,0.5,15.1,3,1,2,0.333,7,0.429,0,0.429,13.8,2016-17
176,202738,Isaiah Thomas,1610612738,BOS,76,51,25,2569.0,42,18,25,0.429,267,0.157,15,0.167,14.1,162,19,145,0.117,341,0.475,17,0.5,11.6,204,37,170,0.181,608,0.336,32,0.354,12.1,2016-17
177,1627785,Isaiah Whitehead,1610612751,BKN,73,17,56,1643.0,32,21,11,0.656,139,0.23,7,0.242,9.5,152,32,120,0.211,313,0.486,33,0.543,8.7,184,53,131,0.288,452,0.407,40,0.447,8.9,2016-17
178,202397,Ish Smith,1610612765,DET,81,37,44,1955.0,21,3,19,0.143,119,0.176,4,0.183,17.6,214,30,185,0.14,459,0.466,68,0.547,8.1,235,33,204,0.14,578,0.407,72,0.464,9.1,2016-17
179,1627826,Ivica Zubac,1610612747,LAL,38,8,30,609.0,41,29,11,0.707,110,0.373,2,0.38,4.2,118,52,65,0.441,227,0.52,19,0.567,4.9,159,81,76,0.509,337,0.472,21,0.503,4.8,2016-17
180,200826,J.J. Barea,1610612742,DAL,34,10,24,751.0,9,1,8,0.111,45,0.2,0,0.2,18.1,74,6,68,0.081,144,0.514,15,0.574,8.9,83,7,76,0.084,189,0.439,15,0.477,9.9,2016-17
181,200755,JJ Redick,1610612746,LAC,78,50,28,2198.0,11,1,10,0.091,63,0.175,2,0.18,16.6,160,19,138,0.119,325,0.492,40,0.561,9.1,171,20,148,0.117,387,0.442,42,0.496,9.5,2016-17
182,2747,JR Smith,1610612739,CLE,41,25,16,1187.0,17,6,12,0.353,48,0.354,1,0.362,16.5,96,19,78,0.198,163,0.589,15,0.649,9.6,113,25,90,0.221,210,0.538,16,0.582,10.7,2016-17
183,203210,JaMychal Green,1610612763,MEM,77,40,37,2101.0,167,120,44,0.719,358,0.466,8,0.477,5.8,377,111,263,0.294,571,0.66,41,0.711,5.1,544,231,307,0.425,925,0.588,49,0.621,5.3,2016-17
184,201580,JaVale McGee,1610612744,GSW,77,62,15,739.0,100,67,31,0.67,200,0.5,5,0.513,5.2,144,62,76,0.431,261,0.552,30,0.623,4.4,244,129,107,0.529,461,0.529,35,0.573,4.7,2016-17
185,203953,Jabari Parker,1610612749,MIL,51,22,29,1728.0,79,44,29,0.557,234,0.338,7,0.348,7.5,235,62,169,0.264,414,0.568,34,0.618,6.4,314,106,198,0.338,648,0.485,41,0.517,6.7,2016-17
186,203109,Jae Crowder,1610612738,BOS,72,48,24,2335.0,48,14,36,0.292,203,0.236,5,0.242,10.9,367,78,288,0.213,555,0.661,33,0.703,6.9,415,92,324,0.222,754,0.55,38,0.58,7.4,2016-17
187,1626143,Jahlil Okafor,1610612755,PHI,50,15,35,1134.0,81,61,18,0.753,251,0.323,5,0.329,5.7,159,60,101,0.377,324,0.491,38,0.556,4.9,240,121,119,0.504,574,0.418,43,0.452,5.2,2016-17
188,1627774,Jake Layman,1610612757,POR,35,16,19,249.0,6,4,3,0.667,18,0.333,0,0.333,7.6,18,6,12,0.333,38,0.474,4,0.529,7.3,24,10,15,0.417,56,0.429,4,0.462,7.4,2016-17
189,1627751,Jakob Poeltl,1610612761,TOR,53,37,16,621.0,77,55,20,0.714,171,0.45,6,0.467,4.7,86,34,51,0.395,178,0.483,22,0.551,4.4,163,89,71,0.546,348,0.468,28,0.509,4.6,2016-17
190,2037,Jamal Crawford,1610612746,LAC,82,51,31,2157.0,17,7,9,0.412,73,0.233,3,0.243,12.3,112,16,98,0.143,225,0.498,14,0.531,11.8,129,23,107,0.178,298,0.433,17,0.459,11.9,2016-17
191,1627750,Jamal Murray,1610612743,DEN,81,39,42,1754.0,40,10,29,0.25,154,0.26,6,0.27,14.8,173,36,135,0.208,287,0.603,28,0.668,8.7,213,46,164,0.216,441,0.483,34,0.523,9.8,2016-17
192,2749,Jameer Nelson,1610612743,DEN,74,33,41,2021.0,28,13,15,0.464,104,0.269,7,0.289,16.4,164,23,140,0.14,309,0.531,26,0.58,9.7,192,36,155,0.188,413,0.465,33,0.505,10.6,2016-17
193,203516,James Ennis III,1610612763,MEM,64,32,32,1501.0,69,43,24,0.623,192,0.359,5,0.369,8.6,190,45,143,0.237,305,0.623,24,0.676,6.3,259,88,167,0.34,496,0.522,29,0.555,6.9,2016-17
194,201935,James Harden,1610612745,HOU,81,54,27,2947.0,95,53,42,0.558,260,0.365,7,0.375,10.9,564,115,444,0.204,854,0.66,56,0.707,6.2,659,168,486,0.255,1113,0.592,63,0.628,6.9,2016-17
195,201949,James Johnson,1610612748,MIA,76,40,36,2085.0,66,27,38,0.409,226,0.292,8,0.303,8.3,310,77,228,0.248,520,0.596,44,0.651,6.0,376,104,266,0.277,745,0.505,52,0.543,6.4,2016-17
196,2592,James Jones,1610612739,CLE,48,28,20,381.0,3,1,2,0.333,17,0.176,1,0.188,13.0,34,12,22,0.353,90,0.378,10,0.425,6.2,37,13,24,0.351,107,0.346,11,0.385,6.8,2016-17
197,203949,James Michael McAdoo,1610612744,GSW,52,43,9,457.0,34,19,13,0.559,100,0.34,3,0.351,7.6,57,19,38,0.333,135,0.422,16,0.479,6.6,91,38,51,0.418,235,0.387,19,0.421,7.0,2016-17
198,203923,James Young,1610612738,BOS,29,16,13,220.0,6,5,1,0.833,14,0.429,0,0.429,10.0,20,6,14,0.3,41,0.488,3,0.526,5.4,26,11,15,0.423,55,0.473,3,0.5,6.5,2016-17
199,201162,Jared Dudley,1610612756,PHX,64,17,47,1362.0,31,15,17,0.484,127,0.244,5,0.254,12.2,194,47,142,0.242,457,0.425,45,0.471,6.6,225,62,159,0.276,584,0.385,50,0.421,7.4,2016-17
200,203096,Jared Sullinger,1610612761,TOR,11,2,9,118.0,10,4,6,0.4,34,0.294,2,0.313,9.1,17,3,14,0.176,38,0.447,5,0.515,4.3,27,7,20,0.259,71,0.38,7,0.422,6.1,2016-17
201,204067,Jarell Eddie,1610612756,PHX,5,0,5,62.0,1,1,0,1.0,4,0.25,0,0.25,2.5,6,1,5,0.167,15,0.4,0,0.4,11.7,7,2,5,0.286,19,0.368,0,0.368,10.3,2016-17
202,1626185,Jarell Martin,1610612763,MEM,42,23,19,558.0,42,29,13,0.69,123,0.341,8,0.365,5.5,120,36,84,0.3,194,0.619,20,0.69,4.9,162,65,97,0.401,317,0.511,28,0.561,5.1,2016-17
203,203950,Jarnell Stokes,1610612743,DEN,2,0,2,7.0,1,0,1,0.0,4,0.25,0,0.25,4.9,1,0,1,0.0,2,0.5,1,1.0,5.0,2,0,2,0.0,6,0.333,1,0.4,4.9,2016-17
204,101127,Jarrett Jack,1610612740,NOP,2,1,1,33.0,0,0,0,0.0,2,0.0,0,0.0,0.0,0,0,0,0.0,2,0.0,1,0.0,0.0,0,0,0,0.0,4,0.0,1,0.0,0.0,2016-17
205,1627784,Jarrod Uthoff,1610612742,DAL,9,2,7,115.0,8,3,5,0.375,22,0.364,0,0.364,8.3,14,3,11,0.214,32,0.438,5,0.519,8.0,22,6,16,0.273,54,0.407,5,0.449,8.1,2016-17
206,201160,Jason Smith,1610612764,WAS,74,45,29,1068.0,64,33,30,0.516,161,0.398,3,0.405,8.3,194,68,123,0.351,344,0.564,25,0.608,5.6,258,101,153,0.391,505,0.511,28,0.541,6.3,2016-17
207,1891,Jason Terry,1610612749,MIL,74,37,37,1365.0,15,1,13,0.067,44,0.341,2,0.357,18.5,91,11,82,0.121,170,0.535,9,0.565,11.1,106,12,95,0.113,214,0.495,11,0.522,12.1,2016-17
208,1627759,Jaylen Brown,1610612738,BOS,78,50,28,1341.0,45,28,14,0.622,164,0.274,4,0.281,6.4,175,42,130,0.24,278,0.629,24,0.689,5.9,220,70,144,0.318,441,0.499,28,0.533,6.0,2016-17
209,201145,Jeff Green,1610612753,ORL,69,26,43,1534.0,39,20,17,0.513,153,0.255,4,0.262,11.1,175,47,127,0.269,303,0.578,19,0.616,7.0,214,67,144,0.313,455,0.47,23,0.495,7.7,2016-17
210,201952,Jeff Teague,1610612754,IND,81,42,39,2632.0,33,11,23,0.333,181,0.182,6,0.189,14.0,294,37,252,0.126,488,0.602,25,0.635,9.1,327,48,275,0.147,668,0.49,31,0.513,9.6,2016-17
211,203481,Jeff Withey,1610612762,UTA,51,33,18,432.0,52,37,12,0.712,103,0.505,2,0.515,4.1,69,24,45,0.348,178,0.388,21,0.439,4.1,121,61,57,0.504,281,0.431,23,0.469,4.1,2016-17
212,203924,Jerami Grant,1610612760,OKC,80,43,37,1531.0,38,16,21,0.421,119,0.319,2,0.325,9.7,167,65,103,0.389,347,0.481,27,0.522,6.7,205,81,124,0.395,465,0.441,29,0.47,7.2,2016-17
213,203087,Jeremy Lamb,1610612766,CHA,62,27,35,1143.0,30,17,14,0.567,92,0.326,2,0.333,7.0,234,45,189,0.192,350,0.669,14,0.696,5.0,264,62,203,0.235,441,0.599,16,0.621,5.2,2016-17
214,202391,Jeremy Lin,1610612751,BKN,35,13,22,858.0,11,3,8,0.273,73,0.151,3,0.157,16.2,122,18,104,0.148,248,0.492,18,0.53,7.7,133,21,112,0.158,320,0.416,21,0.445,8.4,2016-17
215,1626170,Jerian Grant,1610612741,CHI,63,29,34,1028.0,17,5,13,0.294,78,0.218,2,0.224,16.1,94,14,80,0.149,206,0.456,21,0.508,7.7,111,19,93,0.171,284,0.391,23,0.425,9.1,2016-17
216,201573,Jerryd Bayless,1610612755,PHI,3,1,2,71.0,3,2,1,0.667,10,0.3,1,0.333,19.5,9,1,8,0.111,13,0.692,1,0.75,7.7,12,3,9,0.25,23,0.522,2,0.571,10.7,2016-17
217,202710,Jimmy Butler,1610612741,CHI,76,40,36,2809.0,129,69,59,0.535,333,0.387,5,0.393,9.5,341,62,285,0.182,600,0.568,42,0.611,8.0,470,131,344,0.279,933,0.504,47,0.53,8.4,2016-17
218,201149,Joakim Noah,1610612752,NYK,46,17,29,1015.0,162,118,40,0.728,333,0.486,7,0.497,5.3,241,69,170,0.286,443,0.544,35,0.591,4.1,403,187,210,0.464,776,0.519,42,0.549,4.6,2016-17
219,201975,Jodie Meeks,1610612753,ORL,36,14,22,738.0,5,2,3,0.4,31,0.161,2,0.172,14.8,72,17,55,0.236,127,0.567,12,0.626,7.8,77,19,58,0.247,158,0.487,14,0.535,8.3,2016-17
220,203925,Joe Harris,1610612751,BKN,51,10,41,1116.0,16,7,9,0.438,87,0.184,6,0.198,10.3,125,20,103,0.16,247,0.506,27,0.568,7.7,141,27,112,0.191,334,0.422,33,0.468,8.0,2016-17
221,204060,Joe Ingles,1610612762,UTA,82,51,31,1972.0,23,9,12,0.391,86,0.267,4,0.28,16.3,238,40,199,0.168,372,0.64,16,0.669,8.4,261,49,211,0.188,458,0.57,20,0.596,9.0,2016-17
222,2207,Joe Johnson,1610612762,UTA,78,47,31,1843.0,33,15,18,0.455,96,0.344,1,0.347,10.0,210,44,165,0.21,354,0.593,28,0.644,7.4,243,59,183,0.243,449,0.541,29,0.579,7.7,2016-17
223,1626202,Joe Young,1610612754,IND,32,18,14,132.0,1,0,1,0.0,17,0.059,1,0.063,14.7,16,0,16,0.0,24,0.667,1,0.696,9.3,17,0,17,0.0,39,0.436,2,0.459,9.6,2016-17
224,201202,Joel Anthony,1610612759,SAS,19,15,4,122.0,8,6,1,0.75,30,0.267,1,0.276,5.6,23,10,13,0.435,35,0.657,3,0.719,5.2,31,16,14,0.516,65,0.477,4,0.508,5.3,2016-17
225,1627762,Joel Bolomboy,1610612762,UTA,12,8,4,53.0,4,2,1,0.5,8,0.5,0,0.5,5.4,13,4,9,0.308,24,0.542,2,0.591,4.4,17,6,10,0.353,32,0.531,2,0.567,4.6,2016-17
226,203954,Joel Embiid,1610612755,PHI,31,13,18,786.0,61,40,17,0.656,174,0.351,3,0.357,6.8,182,72,112,0.396,300,0.607,29,0.672,4.2,243,112,129,0.461,472,0.515,32,0.552,4.8,2016-17
227,203530,Joffrey Lauvergne,1610612741,CHI,70,41,29,980.0,72,46,24,0.639,183,0.393,5,0.404,6.1,179,61,118,0.341,297,0.603,25,0.658,4.4,251,107,142,0.426,480,0.523,30,0.558,4.9,2016-17
228,203089,John Henson,1610612749,MIL,58,26,32,1122.0,92,61,29,0.663,205,0.449,3,0.455,5.4,203,78,123,0.384,340,0.597,19,0.632,5.5,295,139,152,0.471,541,0.545,22,0.568,5.5,2016-17
229,203098,John Jenkins,1610612756,PHX,4,0,4,13.0,0,0,0,0.0,0,0.0,0,0.0,0.0,1,0,1,0.0,3,0.333,1,0.5,10.1,1,0,1,0.0,3,0.333,1,0.5,10.1,2016-17
230,101249,John Lucas III,1610612750,MIN,5,3,2,11.0,0,0,0,0.0,0,0.0,0,0.0,0.0,0,0,0,0.0,0,0.0,0,0.0,0.0,0,0,0,0.0,0,0.0,0,0.0,0.0,2016-17
231,202322,John Wall,1610612764,WAS,78,48,30,2836.0,59,21,35,0.356,311,0.19,28,0.208,13.4,267,34,238,0.127,479,0.557,25,0.588,11.1,326,55,273,0.169,790,0.413,53,0.442,11.5,2016-17
232,203948,Johnny O'Bryant III,1610612766,CHA,11,4,7,81.0,9,5,3,0.556,15,0.6,1,0.643,8.8,10,5,6,0.5,17,0.588,2,0.667,5.3,19,10,9,0.526,32,0.594,3,0.655,6.8,2016-17
233,202720,Jon Leuer,1610612765,DET,75,34,41,1944.0,102,68,31,0.667,246,0.415,8,0.429,6.0,300,86,217,0.287,516,0.581,56,0.652,4.7,402,154,248,0.383,760,0.529,64,0.578,5.0,2016-17
234,201973,Jonas Jerebko,1610612738,BOS,78,51,27,1232.0,59,28,31,0.475,175,0.337,3,0.343,8.3,213,52,160,0.244,371,0.574,26,0.617,4.8,272,80,191,0.294,544,0.5,29,0.528,5.5,2016-17
235,202685,Jonas Valanciunas,1610612761,TOR,79,49,30,2043.0,223,173,37,0.776,515,0.433,13,0.444,4.2,522,217,305,0.416,854,0.611,61,0.658,3.5,745,390,342,0.523,1367,0.545,74,0.576,3.7,2016-17
236,1626780,Jonathan Gibson,1610612742,DAL,17,4,13,231.0,1,1,0,1.0,15,0.067,1,0.071,4.4,21,2,19,0.095,34,0.618,1,0.636,10.3,22,3,19,0.136,49,0.449,2,0.468,10.0,2016-17
237,203613,Jonathon Simmons,1610612759,SAS,77,60,17,1376.0,20,9,11,0.45,102,0.196,3,0.202,10.6,137,29,107,0.212,258,0.531,20,0.576,7.9,157,38,118,0.242,358,0.439,23,0.469,8.2,2016-17
238,203903,Jordan Clarkson,1610612747,LAL,82,26,56,2397.0,49,19,29,0.388,242,0.202,10,0.211,12.1,197,17,181,0.086,376,0.524,20,0.553,10.1,246,36,210,0.146,618,0.398,30,0.418,10.5,2016-17
239,202348,Jordan Crawford,1610612740,NOP,19,9,10,442.0,4,0,4,0.0,17,0.235,0,0.235,11.8,30,5,25,0.167,55,0.545,3,0.577,8.4,34,5,29,0.147,72,0.472,3,0.493,8.8,2016-17
240,200770,Jordan Farmar,1610612758,SAC,2,1,1,35.0,1,0,1,0.0,1,1.0,0,1.0,19.0,2,0,2,0.0,7,0.286,1,0.333,10.4,3,0,3,0.0,8,0.375,1,0.429,13.2,2016-17
241,201941,Jordan Hill,1610612750,MIN,7,2,5,47.0,8,5,3,0.625,10,0.8,0,0.8,5.3,6,1,5,0.167,17,0.353,3,0.429,5.1,14,6,8,0.429,27,0.519,3,0.583,5.2,2016-17
242,203895,Jordan McRae,1610612739,CLE,37,26,11,384.0,6,3,3,0.5,34,0.176,0,0.176,10.7,35,7,27,0.2,64,0.547,4,0.583,8.8,41,10,30,0.244,98,0.418,4,0.436,9.1,2016-17
243,1626175,Jordan Mickey,1610612738,BOS,25,9,16,141.0,13,8,5,0.615,35,0.371,1,0.382,5.8,21,9,12,0.429,49,0.429,5,0.477,3.5,34,17,17,0.5,84,0.405,6,0.436,4.4,2016-17
244,101181,Jose Calderon,1610612737,ATL,41,15,26,539.0,15,4,11,0.267,39,0.385,0,0.385,16.4,59,11,47,0.186,113,0.522,6,0.551,8.8,74,15,58,0.203,152,0.487,6,0.507,10.4,2016-17
245,203962,Josh Huestis,1610612760,OKC,2,0,2,31.0,4,1,3,0.25,7,0.571,0,0.571,16.8,5,0,5,0.0,8,0.625,1,0.714,5.6,9,1,8,0.111,15,0.6,1,0.643,10.6,2016-17
246,201177,Josh McRoberts,1610612748,MIA,22,6,16,381.0,23,14,9,0.609,56,0.411,1,0.418,6.8,51,18,33,0.353,99,0.515,8,0.56,5.8,74,32,42,0.432,155,0.477,9,0.507,6.2,2016-17
247,1626196,Josh Richardson,1610612748,MIA,53,23,30,1614.0,35,11,23,0.314,109,0.321,6,0.34,12.4,133,27,105,0.203,311,0.428,33,0.478,9.6,168,38,128,0.226,420,0.4,39,0.441,10.2,2016-17
248,201950,Jrue Holiday,1610612740,NOP,67,32,35,2190.0,46,27,19,0.587,165,0.279,4,0.286,9.1,218,43,174,0.197,425,0.513,38,0.563,8.7,264,70,193,0.265,590,0.447,42,0.482,8.8,2016-17
249,1627823,Juancho Hernangomez,1610612743,DEN,61,29,32,839.0,43,30,13,0.698,129,0.333,7,0.352,5.5,144,45,95,0.313,230,0.626,18,0.679,5.0,187,75,108,0.401,359,0.521,25,0.56,5.2,2016-17
250,203944,Julius Randle,1610612747,LAL,74,24,50,2132.0,150,100,43,0.667,375,0.4,8,0.409,5.9,486,150,333,0.309,740,0.657,71,0.726,5.1,636,250,376,0.393,1114,0.571,79,0.614,5.3,2016-17
251,1626147,Justin Anderson,1610612755,PHI,74,23,51,1225.0,69,33,37,0.478,144,0.479,4,0.493,10.2,175,36,139,0.206,300,0.583,22,0.629,5.0,244,69,176,0.283,444,0.55,26,0.584,6.5,2016-17
252,203120,Justin Hamilton,1610612751,BKN,63,14,49,1153.0,69,47,20,0.681,158,0.437,2,0.442,6.3,182,67,114,0.368,359,0.507,35,0.562,5.0,251,114,134,0.454,516,0.486,37,0.524,5.3,2016-17
253,202712,Justin Harper,1610612755,PHI,3,1,2,31.0,2,0,2,0.0,6,0.333,0,0.333,12.3,3,2,1,0.667,6,0.5,1,0.6,4.4,5,2,3,0.4,12,0.417,1,0.455,7.5,2016-17
254,203200,Justin Holiday,1610612752,NYK,82,31,51,1639.0,27,10,17,0.37,101,0.267,6,0.284,13.4,198,41,154,0.207,321,0.617,27,0.673,7.7,225,51,171,0.227,422,0.533,33,0.578,8.4,2016-17
255,1626159,Justise Winslow,1610612748,MIA,18,4,14,625.0,23,18,6,0.783,86,0.267,2,0.274,7.0,71,18,52,0.254,159,0.447,17,0.5,6.3,94,36,58,0.383,244,0.385,19,0.418,6.5,2016-17
256,203994,Jusuf Nurkic,1610612757,POR,64,33,31,1383.0,154,116,30,0.753,392,0.393,8,0.401,4.9,311,113,193,0.363,553,0.562,49,0.617,4.1,465,229,223,0.492,941,0.494,57,0.526,4.4,2016-17
257,203909,KJ McDaniels,1610612751,BKN,49,28,21,505.0,15,11,4,0.733,55,0.273,3,0.288,6.2,67,18,49,0.269,124,0.54,8,0.578,6.6,82,29,53,0.354,178,0.461,11,0.491,6.5,2016-17
258,1626157,Karl-Anthony Towns,1610612750,MIN,82,31,51,3030.0,296,222,69,0.75,660,0.448,16,0.46,6.1,711,265,445,0.373,1045,0.68,63,0.724,4.4,1007,487,514,0.484,1704,0.591,79,0.62,4.9,2016-17
259,202695,Kawhi Leonard,1610612759,SAS,73,54,19,2442.0,79,41,38,0.519,212,0.373,8,0.387,9.3,347,102,246,0.294,570,0.609,34,0.647,7.0,426,143,284,0.336,781,0.545,42,0.576,7.5,2016-17
260,1627770,Kay Felder,1610612739,CLE,42,25,17,386.0,3,3,0,1.0,29,0.103,2,0.111,4.0,38,8,30,0.211,69,0.551,7,0.613,8.7,41,11,30,0.268,98,0.418,9,0.461,8.3,2016-17
261,203482,Kelly Olynyk,1610612738,BOS,75,49,26,1538.0,73,49,23,0.671,223,0.327,3,0.332,7.1,288,67,221,0.233,492,0.585,44,0.643,5.2,361,116,244,0.321,715,0.505,47,0.54,5.6,2016-17
262,1626162,Kelly Oubre Jr.,1610612764,WAS,79,47,32,1605.0,61,38,24,0.623,195,0.313,4,0.319,8.2,200,46,153,0.23,334,0.599,30,0.658,6.2,261,84,177,0.322,528,0.494,34,0.528,6.7,2016-17
263,202689,Kemba Walker,1610612766,CHA,79,36,43,2739.0,45,19,26,0.422,247,0.182,14,0.193,11.6,263,33,229,0.125,541,0.486,59,0.546,8.3,308,52,255,0.169,788,0.391,73,0.431,8.8,2016-17
264,202702,Kenneth Faried,1610612743,DEN,60,28,32,1280.0,179,141,33,0.788,371,0.482,5,0.489,5.3,274,99,175,0.361,424,0.646,31,0.697,4.9,453,240,208,0.53,793,0.571,36,0.598,5.1,2016-17
265,203145,Kent Bazemore,1610612737,ATL,73,39,34,1963.0,45,17,26,0.378,153,0.294,1,0.296,11.0,186,31,152,0.167,432,0.431,44,0.479,7.0,231,48,178,0.208,584,0.396,45,0.429,7.8,2016-17
266,203484,Kentavious Caldwell-Pope,1610612765,DET,76,33,43,2528.0,55,30,24,0.545,153,0.359,3,0.367,10.7,193,25,170,0.13,320,0.603,23,0.65,8.9,248,55,194,0.222,473,0.524,26,0.555,9.4,2016-17
267,201142,Kevin Durant,1610612744,GSW,62,51,11,2070.0,39,20,22,0.513,142,0.275,4,0.283,8.5,474,123,346,0.259,662,0.716,33,0.754,6.3,513,143,368,0.279,802,0.64,37,0.671,6.5,2016-17
268,201567,Kevin Love,1610612739,CLE,60,40,20,1885.0,148,97,49,0.655,328,0.451,11,0.467,6.6,518,160,354,0.309,758,0.683,48,0.73,4.4,666,257,403,0.386,1083,0.615,59,0.65,4.9,2016-17
269,202338,Kevin Seraphin,1610612754,IND,48,23,25,539.0,40,20,18,0.5,107,0.374,4,0.388,7.2,97,19,78,0.196,155,0.626,13,0.683,4.8,137,39,96,0.285,261,0.525,17,0.561,5.5,2016-17
270,1626172,Kevon Looney,1610612744,GSW,53,44,9,447.0,44,24,20,0.545,110,0.4,5,0.419,6.3,80,30,51,0.375,143,0.559,10,0.602,6.0,124,54,71,0.435,253,0.49,15,0.521,6.1,2016-17
271,203114,Khris Middleton,1610612749,MIL,29,19,10,889.0,11,3,8,0.273,46,0.239,2,0.25,12.8,112,23,90,0.205,189,0.593,16,0.647,7.1,123,26,98,0.211,235,0.523,18,0.567,7.6,2016-17
272,202691,Klay Thompson,1610612744,GSW,78,66,12,2649.0,49,20,27,0.408,186,0.263,6,0.272,13.9,236,54,185,0.229,477,0.495,37,0.536,8.0,285,74,212,0.26,662,0.431,43,0.46,8.9,2016-17
273,201585,Kosta Koufos,1610612758,SAC,71,27,44,1419.0,118,75,38,0.636,264,0.447,4,0.454,6.1,285,86,196,0.302,472,0.604,36,0.654,4.4,403,161,234,0.4,732,0.551,40,0.582,4.9,2016-17
274,1627739,Kris Dunn,1610612750,MIN,78,30,48,1333.0,24,12,12,0.5,102,0.235,5,0.247,9.8,142,34,108,0.239,301,0.472,35,0.534,6.8,166,46,120,0.277,403,0.412,40,0.457,7.2,2016-17
275,2743,Kris Humphries,1610612737,ATL,56,31,25,689.0,60,37,22,0.617,149,0.403,2,0.408,6.4,146,52,94,0.356,279,0.523,25,0.575,4.2,206,89,116,0.432,426,0.484,27,0.516,4.8,2016-17
276,204001,Kristaps Porzingis,1610612752,NYK,66,26,40,2164.0,111,72,37,0.649,242,0.459,6,0.47,8.6,364,139,223,0.382,652,0.558,53,0.608,5.2,475,211,260,0.444,894,0.531,59,0.569,6.0,2016-17
277,203937,Kyle Anderson,1610612759,SAS,71,53,18,1011.0,33,23,12,0.697,103,0.32,1,0.324,6.7,175,43,130,0.246,267,0.655,16,0.697,6.3,208,66,142,0.317,368,0.565,17,0.593,6.4,2016-17
278,2594,Kyle Korver,1610612739,CLE,67,33,34,1753.0,7,1,7,0.143,81,0.086,3,0.09,21.3,179,39,138,0.218,370,0.484,36,0.536,7.4,186,40,145,0.215,451,0.412,39,0.451,8.0,2016-17
279,200768,Kyle Lowry,1610612761,TOR,59,35,24,2210.0,46,22,25,0.478,227,0.203,4,0.206,10.6,235,46,191,0.196,522,0.45,47,0.495,8.4,282,68,216,0.241,749,0.377,51,0.404,8.8,2016-17
280,203124,Kyle O'Quinn,1610612752,NYK,79,29,50,1229.0,157,111,42,0.707,331,0.474,7,0.485,5.7,282,105,174,0.372,480,0.588,38,0.638,4.3,439,216,216,0.492,810,0.542,45,0.574,4.8,2016-17
281,202713,Kyle Singler,1610612760,OKC,32,15,17,385.0,8,4,4,0.5,28,0.286,3,0.32,10.7,40,12,28,0.3,79,0.506,4,0.533,7.5,48,16,32,0.333,107,0.449,7,0.48,8.0,2016-17
282,1627787,Kyle Wiltjer,1610612745,HOU,14,12,2,44.0,4,1,3,0.25,6,0.667,0,0.667,7.4,6,2,4,0.333,11,0.545,2,0.667,7.5,10,3,7,0.3,17,0.588,2,0.667,7.5,2016-17
283,202681,Kyrie Irving,1610612739,CLE,72,47,25,2525.0,52,24,27,0.462,230,0.226,13,0.24,10.8,178,25,157,0.14,388,0.459,31,0.499,9.3,230,49,184,0.213,616,0.373,44,0.402,9.6,2016-17
284,200746,LaMarcus Aldridge,1610612759,SAS,71,52,19,2301.0,170,116,50,0.682,360,0.472,10,0.486,5.7,349,106,239,0.304,586,0.596,34,0.632,6.0,519,222,289,0.428,945,0.549,44,0.576,5.9,2016-17
285,203934,Lamar Patterson,1610612737,ATL,5,1,4,40.0,1,1,0,1.0,3,0.333,0,0.333,14.7,6,1,5,0.167,10,0.6,0,0.6,7.7,7,2,5,0.286,13,0.538,0,0.538,8.7,2016-17
286,202362,Lance Stephenson,1610612754,IND,18,8,10,362.0,4,1,3,0.25,31,0.129,4,0.148,8.5,48,6,43,0.125,74,0.649,3,0.676,6.7,52,7,46,0.135,103,0.505,7,0.542,6.8,2016-17
287,202498,Lance Thomas,1610612752,NYK,46,15,31,968.0,32,13,16,0.406,105,0.305,2,0.311,9.1,110,26,83,0.236,217,0.507,13,0.539,7.0,142,39,99,0.275,321,0.442,15,0.464,7.5,2016-17
288,204038,Langston Galloway,1610612758,SAC,74,29,45,1494.0,27,7,19,0.259,77,0.351,3,0.365,10.3,129,15,114,0.116,243,0.531,26,0.594,9.0,156,22,133,0.141,320,0.488,29,0.536,9.2,2016-17
289,1626204,Larry Nance Jr.,1610612747,LAL,63,21,42,1442.0,120,71,47,0.592,273,0.44,11,0.458,6.7,249,77,170,0.309,422,0.59,34,0.642,5.1,369,148,217,0.401,694,0.532,45,0.569,5.6,2016-17
290,202336,Larry Sanders,1610612739,CLE,5,2,3,13.0,3,2,0,0.667,5,0.6,0,0.6,6.2,1,1,0,1.0,1,1.0,0,1.0,1.5,4,3,0,0.75,6,0.667,0,0.667,4.6,2016-17
291,202730,Lavoy Allen,1610612754,IND,60,31,29,868.0,105,80,24,0.762,227,0.463,12,0.488,5.0,114,32,82,0.281,216,0.528,14,0.564,5.3,219,112,106,0.511,443,0.494,26,0.525,5.2,2016-17
292,2544,LeBron James,1610612739,CLE,74,51,23,2795.0,97,52,38,0.536,279,0.348,11,0.362,9.2,542,129,414,0.238,783,0.692,45,0.734,6.2,639,181,452,0.283,1061,0.602,56,0.636,6.7,2016-17
293,2571,Leandro Barbosa,1610612756,PHX,65,19,46,940.0,15,5,10,0.333,75,0.2,4,0.211,13.8,86,8,78,0.093,154,0.558,16,0.623,8.0,101,13,88,0.129,229,0.441,20,0.483,8.9,2016-17
294,101150,Lou Williams,1610612745,HOU,81,34,47,1993.0,26,11,15,0.423,158,0.165,6,0.171,14.0,176,28,147,0.159,330,0.533,23,0.573,9.4,202,39,162,0.193,488,0.414,29,0.44,10.0,2016-17
295,201601,Luc Mbah a Moute,1610612746,LAC,80,49,31,1787.0,44,22,22,0.5,131,0.336,5,0.349,10.6,126,38,87,0.302,304,0.414,34,0.467,8.2,170,60,109,0.353,435,0.391,39,0.429,8.8,2016-17
296,203512,Lucas Nogueira,1610612761,TOR,56,33,23,1067.0,79,50,28,0.633,158,0.5,7,0.523,6.9,159,54,101,0.34,310,0.513,28,0.564,4.6,238,104,129,0.437,468,0.509,35,0.55,5.4,2016-17
297,2449,Luis Scola,1610612751,BKN,35,7,28,443.0,47,29,16,0.617,88,0.534,3,0.553,5.5,87,26,62,0.299,165,0.527,21,0.604,5.0,134,55,78,0.41,252,0.532,24,0.588,5.1,2016-17
298,202337,Luke Babbitt,1610612748,MIA,68,35,33,1065.0,12,1,11,0.083,45,0.267,6,0.308,20.0,129,27,103,0.209,311,0.415,30,0.459,6.3,141,28,114,0.199,355,0.397,36,0.442,7.4,2016-17
299,2736,Luol Deng,1610612747,LAL,56,18,38,1486.0,63,41,22,0.651,174,0.362,11,0.387,8.4,232,56,175,0.241,397,0.584,32,0.636,6.1,295,97,197,0.329,568,0.519,43,0.562,6.5,2016-17
300,1627781,Malachi Richardson,1610612758,SAC,22,9,13,198.0,3,0,3,0.0,8,0.375,0,0.375,19.5,20,2,18,0.1,38,0.526,3,0.571,6.8,23,2,21,0.087,46,0.5,3,0.535,8.5,2016-17
301,1627763,Malcolm Brogdon,1610612749,MIL,75,38,37,1982.0,47,20,28,0.426,141,0.333,5,0.346,12.0,166,45,122,0.271,381,0.436,27,0.469,8.4,213,65,150,0.305,522,0.408,32,0.435,9.2,2016-17
302,1627098,Malcolm Delaney,1610612737,ATL,73,37,36,1248.0,10,4,5,0.4,57,0.175,3,0.185,17.4,113,14,98,0.124,246,0.459,25,0.511,8.2,123,18,103,0.146,303,0.406,28,0.447,8.9,2016-17
303,1627736,Malik Beasley,1610612743,DEN,21,11,10,162.0,4,2,2,0.5,16,0.25,0,0.25,4.3,12,3,9,0.25,30,0.4,4,0.462,5.0,16,5,11,0.313,46,0.348,4,0.381,4.8,2016-17
304,202412,Manny Harris,1610612742,DAL,4,1,3,25.0,3,3,0,1.0,9,0.333,1,0.375,5.1,6,0,6,0.0,10,0.6,0,0.6,4.5,9,3,6,0.333,19,0.474,1,0.5,4.7,2016-17
305,1938,Manu Ginobili,1610612759,SAS,68,51,17,1266.0,28,16,12,0.571,109,0.257,8,0.277,11.6,127,21,104,0.165,245,0.518,15,0.552,8.0,155,37,116,0.239,354,0.438,23,0.468,8.6,2016-17
306,201188,Marc Gasol,1610612763,MEM,74,40,34,2531.0,60,32,26,0.533,170,0.353,10,0.375,10.3,404,160,239,0.396,703,0.575,74,0.642,5.0,464,192,265,0.414,871,0.533,84,0.59,5.7,2016-17
307,1626273,Marcelo Huertas,1610612747,LAL,23,5,18,237.0,2,0,2,0.0,13,0.154,0,0.154,14.5,22,3,19,0.136,39,0.564,1,0.579,8.8,24,3,21,0.125,51,0.471,1,0.48,9.3,2016-17
308,101162,Marcin Gortat,1610612764,WAS,82,49,33,2556.0,238,153,83,0.643,589,0.404,16,0.415,6.3,611,181,428,0.296,992,0.616,84,0.673,4.4,849,334,511,0.393,1576,0.539,100,0.575,5.0,2016-17
309,201158,Marco Belinelli,1610612766,CHA,74,34,40,1778.0,14,6,9,0.429,84,0.167,2,0.171,12.3,164,15,147,0.091,285,0.575,24,0.628,8.3,178,21,156,0.118,369,0.482,26,0.519,8.6,2016-17
310,1627875,Marcus Georges-Hunt,1610612753,ORL,5,2,3,48.0,1,1,0,1.0,2,0.5,0,0.5,5.9,8,1,7,0.125,12,0.667,1,0.727,5.9,9,2,7,0.222,14,0.643,1,0.692,5.9,2016-17
311,202694,Marcus Morris Sr.,1610612765,DET,79,36,43,2565.0,77,41,29,0.532,244,0.316,5,0.322,8.9,289,72,214,0.249,526,0.549,38,0.592,6.6,366,113,243,0.309,768,0.477,43,0.505,7.1,2016-17
312,203935,Marcus Smart,1610612738,BOS,79,51,28,2399.0,78,49,30,0.628,271,0.288,5,0.293,7.2,227,78,146,0.344,409,0.555,27,0.594,7.9,305,127,176,0.416,680,0.449,32,0.471,7.7,2016-17
313,201977,Marcus Thornton,1610612764,WAS,33,15,18,575.0,22,11,8,0.5,63,0.349,1,0.355,5.7,54,10,43,0.185,96,0.563,6,0.6,7.8,76,21,51,0.276,159,0.478,7,0.5,7.3,2016-17
314,1626209,Mario Hezonja,1610612753,ORL,65,20,45,960.0,20,8,12,0.4,86,0.233,4,0.244,12.0,126,36,92,0.286,214,0.589,19,0.646,5.4,146,44,104,0.301,299,0.488,23,0.529,6.3,2016-17
315,202693,Markieff Morris,1610612764,WAS,76,45,31,2374.0,107,72,33,0.673,263,0.407,9,0.421,5.5,386,119,261,0.308,606,0.637,54,0.699,5.4,493,191,294,0.387,869,0.567,63,0.612,5.4,2016-17
316,1627737,Marquese Chriss,1610612756,PHX,80,23,57,1705.0,94,61,30,0.649,275,0.342,6,0.349,5.6,246,69,175,0.28,408,0.603,36,0.661,5.4,340,130,205,0.382,681,0.499,42,0.532,5.5,2016-17
317,201578,Marreese Speights,1610612746,LAC,82,51,31,1286.0,88,73,14,0.83,223,0.395,4,0.402,4.8,285,104,179,0.365,479,0.595,38,0.646,4.0,373,177,193,0.475,702,0.531,42,0.565,4.2,2016-17
318,1627850,Marshall Plumlee,1610612752,NYK,21,6,15,170.0,23,11,11,0.478,56,0.411,0,0.411,5.1,28,7,21,0.25,54,0.519,6,0.583,6.4,51,18,32,0.353,110,0.464,6,0.49,5.8,2016-17
319,101107,Marvin Williams,1610612766,CHA,76,32,44,2295.0,89,52,36,0.584,221,0.403,8,0.418,8.4,411,96,312,0.234,674,0.61,63,0.673,5.8,500,148,348,0.296,894,0.559,71,0.608,6.3,2016-17
320,203486,Mason Plumlee,1610612743,DEN,81,38,43,2148.0,170,102,69,0.6,460,0.37,12,0.379,5.7,435,142,292,0.326,778,0.559,74,0.618,4.6,605,244,361,0.403,1236,0.489,86,0.526,4.9,2016-17
321,2440,Matt Barnes,1610612744,GSW,74,38,36,1776.0,70,40,29,0.571,204,0.343,6,0.354,7.9,314,86,227,0.274,502,0.625,31,0.667,5.4,384,126,256,0.328,703,0.546,37,0.577,5.9,2016-17
322,203521,Matthew Dellavedova,1610612749,MIL,76,39,37,1986.0,24,11,13,0.458,128,0.188,5,0.195,11.9,123,22,101,0.179,306,0.402,22,0.433,11.4,147,33,114,0.224,434,0.339,27,0.361,11.5,2016-17
323,203090,Maurice Harkless,1610612757,POR,77,38,39,2223.0,125,79,39,0.632,341,0.367,14,0.382,6.4,216,68,143,0.315,422,0.512,33,0.555,7.3,341,147,182,0.431,762,0.448,47,0.477,7.0,2016-17
324,1626254,Maurice Ndour,1610612752,NYK,32,10,22,331.0,22,13,10,0.591,56,0.393,2,0.407,7.3,42,10,30,0.238,88,0.477,6,0.512,6.1,64,23,40,0.359,144,0.444,8,0.471,6.6,2016-17
325,1897,Metta World Peace,1610612747,LAL,25,8,17,160.0,5,1,3,0.2,19,0.263,0,0.263,14.3,15,2,13,0.133,26,0.577,2,0.625,7.8,20,3,16,0.15,45,0.444,2,0.465,9.1,2016-17
326,203086,Meyers Leonard,1610612757,POR,74,37,37,1222.0,27,14,12,0.519,97,0.278,2,0.284,8.3,210,68,141,0.324,391,0.537,32,0.585,4.7,237,82,153,0.346,488,0.486,34,0.522,5.1,2016-17
327,201563,Michael Beasley,1610612749,MIL,56,23,33,934.0,40,27,12,0.675,104,0.385,2,0.392,5.9,153,59,93,0.386,244,0.627,16,0.671,4.9,193,86,105,0.446,348,0.555,18,0.585,5.1,2016-17
328,203487,Michael Carter-Williams,1610612741,CHI,45,25,20,846.0,24,11,12,0.458,91,0.264,4,0.276,12.0,129,27,102,0.209,224,0.576,11,0.606,6.6,153,38,114,0.248,315,0.486,15,0.51,7.5,2016-17
329,1627771,Michael Gbinije,1610612765,DET,9,7,2,32.0,2,1,0,0.5,5,0.4,0,0.4,4.3,1,0,1,0.0,2,0.5,0,0.5,6.0,3,1,1,0.333,7,0.429,0,0.429,5.2,2016-17
330,203077,Michael Kidd-Gilchrist,1610612766,CHA,81,36,45,2349.0,156,97,57,0.622,358,0.436,14,0.453,7.4,409,116,288,0.284,699,0.585,60,0.64,5.6,565,213,345,0.377,1055,0.536,74,0.576,6.1,2016-17
331,201144,Mike Conley,1610612763,MEM,69,35,34,2292.0,31,10,23,0.323,132,0.235,3,0.24,15.8,210,28,183,0.133,405,0.519,28,0.557,9.6,241,38,206,0.158,537,0.449,31,0.476,10.6,2016-17
332,2399,Mike Dunleavy,1610612737,ATL,53,34,19,841.0,18,7,11,0.389,70,0.257,1,0.261,11.8,97,22,76,0.227,214,0.453,13,0.483,6.9,115,29,87,0.252,284,0.405,14,0.426,7.6,2016-17
333,2034,Mike Miller,1610612743,DEN,19,8,11,148.0,2,0,2,0.0,8,0.25,0,0.25,24.5,35,5,30,0.143,52,0.673,2,0.7,5.0,37,5,32,0.135,60,0.617,2,0.638,6.0,2016-17
334,203488,Mike Muscala,1610612737,ATL,70,36,34,1237.0,76,51,23,0.671,206,0.369,2,0.373,8.1,164,66,97,0.402,370,0.443,40,0.497,5.5,240,117,120,0.488,575,0.417,42,0.45,6.3,2016-17
335,203118,Mike Scott,1610612737,ATL,18,7,11,195.0,10,3,7,0.3,31,0.323,1,0.333,8.2,27,6,20,0.222,52,0.519,3,0.551,6.9,37,9,27,0.243,83,0.446,4,0.468,7.3,2016-17
336,1627861,Mike Tobey,1610612766,CHA,2,0,2,25.0,2,2,0,1.0,4,0.5,0,0.5,2.8,1,0,1,0.0,4,0.25,1,0.333,8.5,3,2,1,0.667,8,0.375,1,0.429,4.7,2016-17
337,203101,Miles Plumlee,1610612766,CHA,45,19,26,485.0,38,20,15,0.526,108,0.352,1,0.355,7.6,57,26,31,0.456,153,0.373,20,0.429,4.2,95,46,46,0.484,260,0.365,21,0.397,5.5,2016-17
338,1627851,Mindaugas Kuzminskas,1610612752,NYK,68,24,44,1016.0,47,32,17,0.681,144,0.326,2,0.331,5.5,79,19,61,0.241,168,0.47,13,0.51,8.3,126,51,78,0.405,312,0.404,15,0.424,7.3,2016-17
339,203141,Mirza Teletovic,1610612749,MIL,70,36,34,1133.0,11,8,4,0.727,46,0.239,1,0.244,11.5,151,46,104,0.305,287,0.526,17,0.559,5.6,162,54,108,0.333,333,0.486,18,0.514,6.0,2016-17
340,101145,Monta Ellis,1610612754,IND,73,39,34,1971.0,18,5,13,0.278,132,0.136,4,0.141,14.4,184,31,151,0.168,312,0.59,13,0.615,9.1,202,36,164,0.178,443,0.456,17,0.474,9.6,2016-17
341,1626149,Montrezl Harrell,1610612745,HOU,58,39,19,1064.0,81,48,30,0.593,193,0.42,4,0.429,6.0,138,48,86,0.348,277,0.498,24,0.545,5.8,219,96,116,0.438,470,0.466,28,0.495,5.8,2016-17
342,1626167,Myles Turner,1610612754,IND,80,42,38,2520.0,137,88,44,0.642,317,0.432,9,0.445,6.2,446,194,255,0.435,917,0.486,108,0.551,4.3,583,282,299,0.484,1233,0.473,117,0.522,4.7,2016-17
343,202357,Nemanja Bjelica,1610612750,MIN,65,28,37,1190.0,57,38,18,0.667,139,0.41,6,0.429,7.7,187,66,120,0.353,322,0.581,18,0.615,5.7,244,104,138,0.426,461,0.529,24,0.558,6.1,2016-17
344,2403,Nene,1610612745,HOU,67,47,20,1198.0,95,59,34,0.621,248,0.383,5,0.391,7.2,187,81,105,0.433,380,0.492,37,0.545,4.9,282,140,139,0.496,627,0.45,42,0.482,5.6,2016-17
345,203457,Nerlens Noel,1610612742,DAL,51,24,27,1047.0,93,56,35,0.602,213,0.437,7,0.451,6.3,201,79,121,0.393,353,0.569,42,0.646,4.2,294,135,156,0.459,566,0.519,49,0.569,4.8,2016-17
346,2555,Nick Collison,1610612760,OKC,20,10,10,128.0,9,5,4,0.556,29,0.31,1,0.321,3.9,22,8,14,0.364,42,0.524,1,0.537,6.2,31,13,18,0.419,71,0.437,2,0.449,5.5,2016-17
347,201156,Nick Young,1610612747,LAL,60,19,41,1556.0,25,8,17,0.32,87,0.287,7,0.313,15.6,113,22,90,0.195,236,0.479,20,0.523,8.8,138,30,107,0.217,323,0.427,27,0.466,10.0,2016-17
348,201587,Nicolas Batum,1610612766,CHA,77,35,42,2617.0,46,26,17,0.565,248,0.185,9,0.192,10.0,435,98,337,0.225,632,0.688,37,0.731,5.8,481,124,354,0.258,878,0.548,46,0.578,6.2,2016-17
349,1627852,Nicolas Brussino,1610612742,DAL,54,18,36,521.0,26,13,14,0.5,54,0.481,0,0.481,12.5,69,15,54,0.217,116,0.595,5,0.622,7.2,95,28,68,0.295,170,0.559,5,0.576,8.7,2016-17
350,1627879,Nicolas Laprovittola,1610612759,SAS,18,15,3,174.0,1,0,1,0.0,12,0.083,0,0.083,22.2,9,1,7,0.111,26,0.346,3,0.391,9.6,10,1,8,0.1,38,0.263,3,0.286,11.0,2016-17
351,203917,Nik Stauskas,1610612755,PHI,80,27,53,2188.0,21,5,18,0.238,113,0.186,4,0.193,18.4,205,25,180,0.122,377,0.544,23,0.579,7.9,226,30,198,0.133,489,0.462,27,0.489,8.9,2016-17
352,203999,Nikola Jokic,1610612743,DEN,72,36,36,2008.0,209,159,44,0.761,424,0.493,7,0.501,5.0,499,178,313,0.357,802,0.622,75,0.686,4.4,708,337,357,0.476,1226,0.577,82,0.619,4.6,2016-17
353,202703,Nikola Mirotic,1610612741,CHI,70,37,33,1679.0,61,34,27,0.557,159,0.384,3,0.391,7.2,323,100,224,0.31,545,0.593,40,0.64,5.1,384,134,251,0.349,702,0.547,43,0.583,5.5,2016-17
354,202696,Nikola Vucevic,1610612753,ORL,75,27,48,2163.0,176,128,38,0.727,340,0.518,8,0.53,5.9,603,229,372,0.38,890,0.678,61,0.727,4.3,779,357,410,0.458,1226,0.635,69,0.673,4.7,2016-17
355,203943,Noah Vonleh,1610612757,POR,74,38,36,1265.0,131,100,29,0.763,325,0.403,8,0.413,5.0,256,98,154,0.383,462,0.554,50,0.621,4.0,387,198,183,0.512,785,0.493,58,0.532,4.3,2016-17
356,1626181,Norman Powell,1610612761,TOR,75,46,29,1341.0,26,14,12,0.538,116,0.224,5,0.234,13.1,140,26,116,0.186,273,0.513,19,0.551,7.3,166,40,128,0.241,389,0.427,24,0.455,8.2,2016-17
357,202708,Norris Cole,1610612760,OKC,13,5,8,125.0,0,0,0,0.0,7,0.0,0,0.0,0.0,11,2,8,0.182,24,0.458,3,0.524,10.8,11,2,8,0.182,31,0.355,3,0.393,10.8,2016-17
358,1627855,Okaro White,1610612748,MIA,35,26,9,471.0,25,15,10,0.6,63,0.397,2,0.41,7.7,57,18,39,0.316,125,0.456,17,0.528,5.2,82,33,49,0.402,188,0.436,19,0.485,6.0,2016-17
359,201600,Omer Asik,1610612740,NOP,31,12,19,482.0,48,33,13,0.688,88,0.545,1,0.552,3.9,115,39,74,0.339,207,0.556,18,0.608,4.0,163,72,87,0.442,295,0.553,19,0.591,3.9,2016-17
360,201956,Omri Casspi,1610612750,MIN,36,12,24,642.0,27,16,11,0.593,96,0.281,2,0.287,6.6,85,15,70,0.176,171,0.497,23,0.574,5.4,112,31,81,0.277,266,0.421,25,0.465,5.7,2016-17
361,203490,Otto Porter Jr.,1610612764,WAS,80,48,32,2605.0,118,61,52,0.517,341,0.346,8,0.354,8.6,396,83,308,0.21,673,0.588,52,0.638,5.7,514,144,360,0.28,1013,0.507,60,0.539,6.4,2016-17
362,200782,P.J. Tucker,1610612761,TOR,79,34,45,2180.0,115,72,42,0.626,346,0.332,16,0.348,7.8,343,83,260,0.242,555,0.618,55,0.686,6.0,458,155,302,0.338,899,0.509,71,0.553,6.4,2016-17
363,1627783,Pascal Siakam,1610612761,TOR,54,34,20,832.0,64,40,22,0.625,139,0.46,5,0.478,7.1,118,38,80,0.322,223,0.529,23,0.59,5.4,182,78,102,0.429,362,0.503,28,0.545,6.0,2016-17
364,1626192,Pat Connaughton,1610612757,POR,39,18,21,316.0,10,5,5,0.5,18,0.556,0,0.556,11.6,42,9,33,0.214,71,0.592,8,0.667,5.6,52,14,38,0.269,89,0.584,8,0.642,6.8,2016-17
365,1627868,Patricio Garino,1610612753,ORL,5,2,3,43.0,1,1,0,1.0,2,0.5,0,0.5,3.1,6,0,6,0.0,12,0.5,1,0.545,7.9,7,1,6,0.143,14,0.5,1,0.538,7.2,2016-17
366,201976,Patrick Beverley,1610612745,HOU,67,46,21,2058.0,95,44,49,0.463,271,0.351,6,0.358,10.3,298,57,242,0.191,561,0.531,55,0.589,7.4,393,101,291,0.257,832,0.472,61,0.51,8.1,2016-17
367,1627775,Patrick McCaw,1610612744,GSW,71,57,14,1074.0,21,5,15,0.238,72,0.292,4,0.309,11.9,79,20,58,0.253,153,0.516,15,0.572,8.9,100,25,73,0.25,225,0.444,19,0.485,9.5,2016-17
368,202335,Patrick Patterson,1610612761,TOR,65,42,23,1599.0,62,37,23,0.597,141,0.44,5,0.456,8.9,231,67,165,0.29,403,0.573,27,0.614,6.0,293,104,188,0.355,542,0.541,32,0.575,6.6,2016-17
369,201988,Patty Mills,1610612759,SAS,80,60,20,1754.0,24,7,18,0.292,114,0.211,7,0.224,18.0,117,6,111,0.051,226,0.518,14,0.552,12.0,141,13,129,0.092,340,0.415,21,0.442,13.3,2016-17
370,2200,Pau Gasol,1610612759,SAS,63,47,16,1599.0,107,74,31,0.692,255,0.42,7,0.431,6.7,384,132,254,0.344,583,0.659,39,0.706,4.4,491,206,285,0.42,836,0.587,46,0.622,4.9,2016-17
371,202331,Paul George,1610612754,IND,74,39,35,2658.0,58,30,27,0.517,206,0.282,7,0.291,9.7,430,91,339,0.212,707,0.608,55,0.66,6.0,488,121,366,0.248,912,0.535,62,0.574,6.4,2016-17
372,200794,Paul Millsap,1610612737,ATL,69,40,29,2343.0,111,70,33,0.631,303,0.366,7,0.375,7.8,422,142,280,0.336,784,0.538,61,0.584,5.0,533,212,313,0.398,1086,0.491,68,0.524,5.5,2016-17
373,1718,Paul Pierce,1610612746,LAC,25,16,9,277.0,1,1,0,1.0,10,0.1,1,0.111,2.6,47,15,31,0.319,71,0.662,8,0.746,5.7,48,16,31,0.333,81,0.593,9,0.667,5.6,2016-17
374,1627835,Paul Zipser,1610612741,CHI,44,21,23,843.0,15,5,10,0.333,66,0.227,2,0.234,13.9,110,19,88,0.173,200,0.55,23,0.621,6.0,125,24,98,0.192,266,0.47,25,0.519,7.0,2016-17
375,203510,Pierre Jackson,1610612742,DAL,9,4,5,84.0,1,0,1,0.0,9,0.111,0,0.111,26.7,8,1,7,0.125,17,0.471,2,0.533,10.8,9,1,8,0.111,26,0.346,2,0.375,12.6,2016-17
376,203112,Quincy Acy,1610612751,BKN,38,11,27,558.0,20,15,5,0.75,71,0.282,2,0.29,5.7,95,23,71,0.242,164,0.579,16,0.642,4.1,115,38,76,0.33,235,0.489,18,0.53,4.4,2016-17
377,1626188,Quinn Cook,1610612740,NOP,14,9,5,187.0,1,0,1,0.0,6,0.167,0,0.167,69.0,6,0,6,0.0,20,0.3,2,0.333,8.2,7,0,7,0.0,26,0.269,2,0.292,16.9,2016-17
378,1626154,RJ Hunter,1610612741,CHI,3,2,1,9.0,0,0,0,0.0,0,0.0,0,0.0,0.0,1,0,1,0.0,1,1.0,0,1.0,12.7,1,0,1,0.0,1,1.0,0,1.0,12.7,2016-17
379,200765,Rajon Rondo,1610612741,CHI,69,34,35,1843.0,73,23,49,0.315,233,0.313,5,0.32,11.8,282,27,257,0.096,454,0.621,23,0.654,7.5,355,50,306,0.141,685,0.518,28,0.54,8.4,2016-17
380,1626176,Rakeem Christmas,1610612754,IND,29,14,15,219.0,26,14,11,0.538,65,0.4,1,0.406,6.4,30,8,22,0.267,58,0.517,3,0.545,5.9,56,22,33,0.393,123,0.455,4,0.471,6.1,2016-17
381,201196,Ramon Sessions,1610612766,CHA,50,23,27,811.0,11,6,5,0.545,58,0.19,6,0.212,15.3,62,9,55,0.145,100,0.62,8,0.674,10.5,73,15,60,0.205,158,0.462,14,0.507,11.2,2016-17
382,200751,Randy Foye,1610612751,BKN,68,17,51,1277.0,9,4,6,0.444,85,0.106,1,0.107,16.9,145,16,130,0.11,288,0.503,25,0.551,8.5,154,20,136,0.13,373,0.413,26,0.444,9.1,2016-17
383,1626173,Rashad Vaughn,1610612749,MIL,41,18,23,459.0,4,1,3,0.25,22,0.182,1,0.19,20.2,45,7,38,0.156,86,0.523,9,0.584,6.6,49,8,41,0.163,108,0.454,10,0.5,7.7,2016-17
384,203526,Raul Neto,1610612762,UTA,40,24,16,346.0,4,1,3,0.25,20,0.2,1,0.211,23.9,26,2,25,0.077,64,0.406,8,0.464,10.3,30,3,28,0.1,84,0.357,9,0.4,12.1,2016-17
385,101109,Raymond Felton,1610612746,LAC,80,50,30,1700.0,33,15,16,0.455,131,0.252,7,0.266,11.6,185,41,145,0.222,325,0.569,20,0.607,9.2,218,56,161,0.257,456,0.478,27,0.508,9.6,2016-17
386,203493,Reggie Bullock,1610612765,DET,31,13,18,467.0,13,6,7,0.462,39,0.333,2,0.351,15.5,51,11,39,0.216,77,0.662,8,0.739,6.0,64,17,46,0.266,115,0.557,10,0.61,8.0,2016-17
387,202704,Reggie Jackson,1610612765,DET,52,23,29,1424.0,21,11,10,0.524,101,0.208,7,0.223,11.6,93,16,77,0.172,216,0.431,35,0.514,8.5,114,27,87,0.237,317,0.36,42,0.415,9.1,2016-17
388,202130,Reggie Williams,1610612740,NOP,6,1,5,79.0,2,1,1,0.5,5,0.4,0,0.4,14.4,4,1,3,0.25,10,0.4,1,0.444,5.7,6,2,4,0.333,15,0.4,1,0.429,8.6,2016-17
389,2210,Richard Jefferson,1610612739,CLE,79,50,29,1614.0,28,13,14,0.464,147,0.19,3,0.194,11.4,175,39,133,0.223,387,0.452,34,0.496,7.1,203,52,147,0.256,533,0.381,37,0.409,7.7,2016-17
390,1626158,Richaun Holmes,1610612755,PHI,57,16,41,1193.0,94,65,28,0.691,247,0.381,12,0.4,5.6,217,88,129,0.406,384,0.565,34,0.62,4.4,311,153,157,0.492,630,0.494,46,0.533,4.8,2016-17
391,201937,Ricky Rubio,1610612750,MIN,75,28,47,2469.0,68,20,48,0.294,208,0.327,12,0.347,14.3,237,35,202,0.148,428,0.554,32,0.598,9.6,305,55,250,0.18,636,0.48,44,0.515,10.6,2016-17
392,203496,Robert Covington,1610612755,PHI,67,27,40,2119.0,92,48,42,0.522,238,0.387,12,0.407,9.5,344,108,237,0.314,630,0.546,64,0.608,5.3,436,156,279,0.358,868,0.502,76,0.551,6.1,2016-17
393,201577,Robin Lopez,1610612741,CHI,81,40,41,2271.0,244,192,46,0.787,595,0.41,17,0.422,4.2,276,127,148,0.46,622,0.444,62,0.493,5.3,520,319,194,0.613,1216,0.428,79,0.457,4.8,2016-17
394,203918,Rodney Hood,1610612762,UTA,59,40,19,1593.0,16,7,10,0.438,64,0.25,3,0.262,13.5,186,39,146,0.21,320,0.581,24,0.628,7.5,202,46,156,0.228,382,0.529,27,0.569,8.0,2016-17
395,203585,Rodney McGruder,1610612748,MIA,78,40,38,1966.0,94,42,53,0.447,254,0.37,11,0.387,9.5,162,35,126,0.216,350,0.463,37,0.518,8.6,256,77,179,0.301,604,0.424,48,0.46,8.9,2016-17
396,201155,Rodney Stuckey,1610612754,IND,39,17,22,696.0,6,2,3,0.333,44,0.136,1,0.14,11.2,78,14,64,0.179,136,0.574,9,0.614,9.0,84,16,67,0.19,180,0.467,10,0.494,9.2,2016-17
397,1627758,Ron Baker,1610612752,NYK,52,14,38,857.0,12,5,7,0.417,47,0.255,0,0.255,7.5,86,20,68,0.233,164,0.524,9,0.555,9.0,98,25,75,0.255,211,0.464,9,0.485,8.8,2016-17
398,1626178,Rondae Hollis-Jefferson,1610612751,BKN,77,19,58,1741.0,95,59,35,0.621,280,0.339,7,0.348,7.3,351,98,252,0.279,620,0.566,50,0.616,5.3,446,157,287,0.352,900,0.496,57,0.529,5.8,2016-17
399,101179,Ronnie Price,1610612756,PHX,14,4,10,134.0,3,0,3,0.0,10,0.3,2,0.375,20.9,8,0,8,0.0,20,0.4,2,0.444,11.7,11,0,11,0.0,30,0.367,4,0.423,14.2,2016-17
400,201579,Roy Hibbert,1610612743,DEN,48,24,24,682.0,54,34,16,0.63,136,0.397,2,0.403,4.0,98,37,60,0.378,219,0.447,30,0.519,5.0,152,71,76,0.467,355,0.428,32,0.471,4.7,2016-17
401,200752,Rudy Gay,1610612758,SAC,30,11,19,1013.0,35,21,14,0.6,121,0.289,4,0.299,6.9,155,40,115,0.258,234,0.662,16,0.711,6.1,190,61,129,0.321,355,0.535,20,0.567,6.3,2016-17
402,203497,Rudy Gobert,1610612762,UTA,81,51,30,2744.0,314,236,73,0.752,707,0.444,5,0.447,5.1,721,241,474,0.334,1200,0.601,100,0.655,4.1,1035,477,547,0.461,1904,0.544,105,0.575,4.4,2016-17
403,201566,Russell Westbrook,1610612760,OKC,81,46,35,2802.0,137,75,61,0.547,490,0.28,13,0.287,8.9,727,117,606,0.161,907,0.802,29,0.828,6.1,864,192,667,0.222,1387,0.623,42,0.642,6.6,2016-17
404,201583,Ryan Anderson,1610612745,HOU,72,50,22,2116.0,112,78,35,0.696,274,0.409,10,0.424,6.7,218,74,142,0.339,427,0.511,42,0.566,6.3,330,152,177,0.461,701,0.471,52,0.508,6.4,2016-17
405,203527,Ryan Kelly,1610612737,ATL,16,6,10,110.0,1,0,1,0.0,8,0.125,2,0.167,11.6,17,7,10,0.412,32,0.531,5,0.63,3.9,18,7,11,0.389,40,0.45,7,0.545,4.4,2016-17
406,1626257,Salah Mejri,1610612742,DAL,72,28,44,889.0,95,55,37,0.579,197,0.482,2,0.487,7.4,206,82,123,0.398,326,0.632,24,0.682,4.7,301,137,160,0.455,523,0.576,26,0.606,5.5,2016-17
407,1626155,Sam Dekker,1610612745,HOU,77,52,25,1419.0,94,59,34,0.628,205,0.459,7,0.475,7.0,190,47,142,0.247,376,0.505,30,0.549,7.0,284,106,176,0.373,580,0.49,37,0.523,7.0,2016-17
408,2756,Sasha Vujacic,1610612752,NYK,42,14,28,408.0,12,4,8,0.333,35,0.343,1,0.353,11.8,47,8,39,0.17,91,0.516,14,0.61,9.7,59,12,47,0.203,126,0.468,15,0.532,10.1,2016-17
409,203930,Sean Kilpatrick,1610612751,BKN,69,14,55,1730.0,22,11,8,0.5,155,0.142,4,0.146,9.3,257,24,231,0.093,421,0.61,39,0.673,6.7,279,35,239,0.125,575,0.485,43,0.524,6.9,2016-17
410,203902,Semaj Christon,1610612760,OKC,64,36,28,973.0,19,2,17,0.105,89,0.213,5,0.226,15.6,68,12,58,0.176,158,0.43,13,0.469,9.2,87,14,75,0.161,247,0.352,18,0.38,10.5,2016-17
411,201586,Serge Ibaka,1610612761,TOR,79,37,42,2422.0,129,89,35,0.69,310,0.416,4,0.422,6.1,409,133,275,0.325,709,0.577,68,0.638,4.8,538,222,310,0.413,1018,0.528,72,0.569,5.1,2016-17
412,200771,Sergio Rodriguez,1610612755,PHI,68,24,44,1517.0,21,5,17,0.238,114,0.184,1,0.186,16.6,136,13,123,0.096,226,0.602,7,0.621,11.4,157,18,140,0.115,339,0.463,8,0.474,12.2,2016-17
413,203552,Seth Curry,1610612742,DAL,69,29,40,2005.0,25,7,20,0.28,106,0.236,7,0.253,15.8,150,22,129,0.147,300,0.5,25,0.545,9.8,175,29,149,0.166,405,0.432,32,0.469,10.8,2016-17
414,203498,Shabazz Muhammad,1610612750,MIN,78,29,49,1516.0,84,51,32,0.607,269,0.312,13,0.328,7.4,136,34,102,0.25,215,0.633,11,0.667,6.0,220,85,134,0.386,484,0.455,24,0.478,6.6,2016-17
415,203894,Shabazz Napier,1610612757,POR,53,26,27,512.0,8,3,5,0.375,32,0.25,0,0.25,13.6,53,8,45,0.151,104,0.51,11,0.57,8.1,61,11,50,0.18,136,0.449,11,0.488,8.9,2016-17
416,2733,Shaun Livingston,1610612744,GSW,76,63,13,1345.0,28,9,15,0.321,105,0.267,10,0.295,11.0,123,25,99,0.203,248,0.496,14,0.526,9.2,151,34,114,0.225,353,0.428,24,0.459,9.5,2016-17
417,1627848,Shawn Long,1610612755,PHI,18,5,13,234.0,41,29,11,0.707,79,0.519,3,0.539,5.9,44,17,27,0.386,82,0.537,5,0.571,4.2,85,46,38,0.541,161,0.528,8,0.556,5.0,2016-17
418,1627815,Sheldon Mac,1610612764,WAS,30,17,13,287.0,4,0,4,0.0,20,0.2,2,0.222,11.2,30,4,26,0.133,56,0.536,5,0.588,8.4,34,4,30,0.118,76,0.447,7,0.493,8.7,2016-17
419,202714,Shelvin Mack,1610612762,UTA,55,34,21,1205.0,20,2,19,0.1,89,0.225,3,0.233,17.7,105,17,90,0.162,219,0.479,19,0.525,7.9,125,19,109,0.152,307,0.407,22,0.439,9.6,2016-17
420,1627746,Skal Labissiere,1610612758,SAC,33,9,24,612.0,51,33,18,0.647,122,0.418,4,0.432,5.8,111,30,82,0.27,193,0.575,20,0.642,5.3,162,63,100,0.389,315,0.514,24,0.557,5.5,2016-17
421,203524,Solomon Hill,1610612740,NOP,80,34,46,2374.0,51,30,22,0.588,154,0.331,8,0.349,8.4,256,65,191,0.254,480,0.533,40,0.582,7.5,307,95,213,0.309,634,0.484,48,0.524,7.7,2016-17
422,203915,Spencer Dinwiddie,1610612751,BKN,58,13,45,1312.0,26,11,15,0.423,94,0.277,4,0.289,12.1,134,19,115,0.142,248,0.54,18,0.583,7.7,160,30,130,0.188,342,0.468,22,0.5,8.4,2016-17
423,201150,Spencer Hawes,1610612749,MIL,54,27,27,797.0,38,19,18,0.5,98,0.388,1,0.392,5.9,153,47,106,0.307,282,0.543,33,0.614,5.3,191,66,124,0.346,380,0.503,34,0.552,5.4,2016-17
424,1626169,Stanley Johnson,1610612765,DET,77,35,42,1371.0,36,17,18,0.472,121,0.298,1,0.3,9.0,153,26,127,0.17,279,0.548,24,0.6,6.5,189,43,145,0.228,400,0.473,25,0.504,6.9,2016-17
425,201939,Stephen Curry,1610612744,GSW,79,65,14,2639.0,61,36,27,0.59,294,0.207,10,0.215,11.1,292,40,253,0.137,591,0.494,42,0.532,9.5,353,76,280,0.215,885,0.399,52,0.424,9.8,2016-17
426,1627757,Stephen Zimmerman,1610612753,ORL,19,8,11,108.0,11,8,3,0.727,32,0.344,0,0.344,8.9,24,8,16,0.333,35,0.686,1,0.706,5.3,35,16,19,0.457,67,0.522,1,0.53,6.4,2016-17
427,200779,Steve Novak,1610612749,MIL,8,6,2,22.0,0,0,0,0.0,0,0.0,0,0.0,0.0,3,0,3,0.0,2,1.5,0,1.5,7.0,3,0,3,0.0,2,1.5,0,1.5,7.0,2016-17
428,203500,Steven Adams,1610612760,OKC,80,47,33,2389.0,281,212,60,0.754,645,0.436,11,0.443,5.3,332,116,215,0.349,619,0.536,56,0.59,5.5,613,328,275,0.535,1263,0.485,67,0.513,5.4,2016-17
429,204456,T.J. McConnell,1610612755,PHI,81,27,54,2133.0,39,8,36,0.205,200,0.195,7,0.202,15.0,212,23,192,0.108,384,0.552,24,0.589,9.3,251,31,228,0.124,583,0.431,31,0.455,10.2,2016-17
430,203933,T.J. Warren,1610612756,PHX,64,19,45,1994.0,124,69,53,0.556,279,0.444,5,0.453,9.3,212,66,149,0.311,355,0.597,26,0.644,7.4,336,135,202,0.402,630,0.533,31,0.561,8.1,2016-17
431,201959,Taj Gibson,1610612760,OKC,78,41,37,1989.0,158,110,42,0.696,435,0.363,9,0.371,6.1,327,103,223,0.315,560,0.584,39,0.628,5.2,485,213,265,0.439,992,0.489,48,0.514,5.5,2016-17
432,204028,Tarik Black,1610612747,LAL,67,24,43,1091.0,144,104,38,0.722,333,0.432,11,0.447,4.8,199,75,123,0.377,371,0.536,30,0.584,5.0,343,179,161,0.522,702,0.489,41,0.519,4.9,2016-17
433,1627752,Taurean Prince,1610612737,ATL,59,28,31,981.0,25,14,11,0.56,84,0.298,1,0.301,8.6,132,36,95,0.273,231,0.571,17,0.617,6.2,157,50,106,0.318,315,0.498,18,0.529,6.6,2016-17
434,203093,Terrence Jones,1610612749,MIL,54,20,34,1271.0,65,41,23,0.631,178,0.365,4,0.374,6.2,241,80,158,0.332,422,0.571,24,0.606,5.1,306,121,181,0.395,599,0.511,28,0.536,5.3,2016-17
435,203082,Terrence Ross,1610612753,ORL,77,38,39,1932.0,17,7,9,0.412,73,0.233,5,0.25,13.3,185,40,144,0.216,327,0.566,30,0.623,7.1,202,47,153,0.233,398,0.508,35,0.556,7.6,2016-17
436,1626179,Terry Rozier,1610612738,BOS,74,47,27,1263.0,40,17,23,0.425,126,0.317,6,0.333,10.9,187,34,153,0.182,330,0.567,25,0.613,7.2,227,51,176,0.225,456,0.498,31,0.534,7.8,2016-17
437,200757,Thabo Sefolosha,1610612737,ATL,62,32,30,1596.0,54,26,27,0.481,188,0.287,5,0.295,9.2,216,57,156,0.264,383,0.564,32,0.615,5.7,270,83,183,0.307,571,0.473,37,0.506,6.4,2016-17
438,201152,Thaddeus Young,1610612754,IND,73,40,33,2209.0,130,81,49,0.623,325,0.4,12,0.415,7.8,314,99,210,0.315,555,0.566,46,0.617,6.3,444,180,259,0.405,880,0.505,58,0.54,6.7,2016-17
439,203080,Thomas Robinson,1610612747,LAL,48,15,33,560.0,84,54,29,0.643,186,0.452,3,0.459,6.1,139,40,98,0.288,207,0.671,13,0.716,4.7,223,94,127,0.422,393,0.567,16,0.592,5.2,2016-17
440,1627748,Thon Maker,1610612749,MIL,57,31,26,562.0,40,25,14,0.625,89,0.449,0,0.449,7.2,74,29,45,0.392,179,0.413,24,0.477,5.6,114,54,59,0.474,266,0.429,24,0.471,6.2,2016-17
441,201168,Tiago Splitter,1610612755,PHI,8,1,7,76.0,8,6,1,0.75,20,0.4,2,0.444,3.4,14,4,11,0.286,21,0.667,4,0.824,5.4,22,10,12,0.455,41,0.537,6,0.629,4.8,2016-17
442,204025,Tim Frazier,1610612740,NOP,65,26,39,1525.0,34,16,18,0.471,157,0.217,9,0.23,9.9,139,22,121,0.158,337,0.412,40,0.468,8.0,173,38,139,0.22,494,0.35,49,0.389,8.3,2016-17
443,203501,Tim Hardaway Jr.,1610612737,ATL,79,42,37,2154.0,35,14,18,0.4,155,0.226,5,0.233,12.0,189,39,149,0.206,352,0.537,23,0.574,8.1,224,53,167,0.237,507,0.442,28,0.468,8.8,2016-17
444,1627817,Tim Quarterman,1610612757,POR,16,6,10,80.0,4,3,1,0.75,9,0.444,1,0.5,11.3,10,2,8,0.2,18,0.556,0,0.556,7.1,14,5,9,0.357,27,0.519,1,0.538,8.3,2016-17
445,202389,Timofey Mozgov,1610612747,LAL,54,16,38,1104.0,104,63,38,0.606,263,0.395,9,0.409,5.6,160,60,100,0.375,321,0.498,43,0.576,5.3,264,123,138,0.466,584,0.452,52,0.496,5.5,2016-17
446,1627789,Timothe Luwawu-Cabarrot,1610612755,PHI,69,23,46,1190.0,25,11,14,0.44,121,0.207,4,0.214,10.7,124,29,96,0.234,273,0.454,25,0.5,6.3,149,40,110,0.268,394,0.378,29,0.408,7.0,2016-17
447,202699,Tobias Harris,1610612765,DET,82,37,45,2566.0,63,29,30,0.46,221,0.285,9,0.297,8.9,353,89,262,0.252,592,0.596,56,0.659,5.9,416,118,292,0.284,811,0.513,65,0.558,6.3,2016-17
448,203107,Tomas Satoransky,1610612764,WAS,57,33,24,719.0,25,15,11,0.6,80,0.313,7,0.342,9.4,58,9,49,0.155,132,0.439,6,0.46,8.1,83,24,60,0.289,212,0.392,13,0.417,8.5,2016-17
449,201962,Toney Douglas,1610612763,MEM,24,15,9,394.0,13,4,9,0.308,30,0.433,0,0.433,10.6,48,6,42,0.125,83,0.578,10,0.658,8.6,61,10,51,0.164,113,0.54,10,0.592,9.1,2016-17
450,2754,Tony Allen,1610612763,MEM,71,36,35,1914.0,166,118,46,0.711,427,0.389,13,0.401,6.3,225,51,171,0.227,354,0.636,26,0.686,7.3,391,169,217,0.432,781,0.501,39,0.527,6.9,2016-17
451,2225,Tony Parker,1610612759,SAS,62,46,16,1556.0,8,2,7,0.25,137,0.058,5,0.061,12.5,104,8,95,0.077,242,0.43,22,0.473,10.8,112,10,102,0.089,379,0.296,27,0.318,11.1,2016-17
452,203503,Tony Snell,1610612749,MIL,80,42,38,2336.0,22,4,18,0.182,79,0.278,5,0.297,17.3,226,39,186,0.173,419,0.539,33,0.585,8.2,248,43,204,0.173,497,0.499,38,0.54,9.1,2016-17
453,1626203,Treveon Graham,1610612766,CHA,27,10,17,189.0,5,3,2,0.6,20,0.25,0,0.25,11.6,17,3,14,0.176,33,0.515,4,0.586,6.3,22,6,16,0.273,53,0.415,4,0.449,7.5,2016-17
454,2772,Trevor Ariza,1610612745,HOU,80,53,27,2773.0,54,23,31,0.426,207,0.261,7,0.27,12.3,404,110,294,0.272,652,0.62,48,0.669,6.4,458,133,325,0.29,858,0.534,55,0.57,7.1,2016-17
455,202344,Trevor Booker,1610612751,BKN,70,18,52,1734.0,141,95,45,0.674,378,0.373,5,0.378,6.5,425,113,311,0.266,657,0.647,49,0.699,5.1,566,208,356,0.367,1032,0.548,54,0.579,5.4,2016-17
456,203504,Trey Burke,1610612764,WAS,57,35,22,703.0,7,1,6,0.143,39,0.179,5,0.206,13.1,40,6,34,0.15,105,0.381,10,0.421,10.5,47,7,40,0.149,144,0.326,15,0.364,10.9,2016-17
457,1626168,Trey Lyles,1610612762,UTA,71,43,28,1158.0,48,31,17,0.646,136,0.353,5,0.366,8.2,187,42,147,0.225,363,0.515,33,0.567,5.3,235,73,164,0.311,498,0.472,38,0.511,5.9,2016-17
458,202684,Tristan Thompson,1610612739,CLE,78,50,28,2336.0,286,201,79,0.703,697,0.41,14,0.419,5.4,429,124,302,0.289,778,0.551,64,0.601,5.3,715,325,381,0.455,1473,0.485,78,0.513,5.3,2016-17
459,203584,Troy Daniels,1610612763,MEM,67,33,34,1183.0,22,8,14,0.364,65,0.338,1,0.344,11.5,78,21,57,0.269,178,0.438,23,0.503,7.0,100,29,71,0.29,243,0.412,24,0.457,8.0,2016-17
460,1627786,Troy Williams,1610612745,HOU,30,19,11,557.0,15,7,7,0.467,55,0.273,1,0.278,9.2,54,10,43,0.185,110,0.491,11,0.545,5.8,69,17,50,0.246,165,0.418,12,0.451,6.5,2016-17
461,201951,Ty Lawson,1610612758,SAC,69,25,44,1732.0,44,16,28,0.364,152,0.289,4,0.297,11.8,135,9,127,0.067,247,0.547,16,0.584,10.6,179,25,155,0.14,398,0.45,20,0.474,10.9,2016-17
462,203898,Tyler Ennis,1610612747,LAL,53,28,25,588.0,9,2,8,0.222,50,0.18,3,0.191,15.7,36,8,29,0.222,93,0.387,13,0.45,9.0,45,10,37,0.222,143,0.315,16,0.354,10.4,2016-17
463,204020,Tyler Johnson,1610612748,MIA,73,35,38,2177.0,50,26,23,0.52,225,0.222,9,0.231,9.9,243,46,198,0.189,505,0.481,49,0.533,7.7,293,72,221,0.246,730,0.401,58,0.436,8.1,2016-17
464,1627755,Tyler Ulis,1610612756,PHX,59,14,45,1103.0,19,3,15,0.158,101,0.188,4,0.196,18.5,75,7,68,0.093,166,0.452,13,0.49,10.3,94,10,83,0.106,267,0.352,17,0.376,12.0,2016-17
465,203092,Tyler Zeller,1610612738,BOS,51,32,19,525.0,43,32,10,0.744,107,0.402,3,0.413,7.4,81,35,46,0.432,167,0.485,12,0.523,5.5,124,67,56,0.54,273,0.454,15,0.481,6.2,2016-17
466,201936,Tyreke Evans,1610612758,SAC,40,17,23,788.0,13,6,7,0.462,91,0.143,3,0.148,5.9,124,30,95,0.242,203,0.611,12,0.649,6.4,137,36,102,0.263,294,0.466,15,0.491,6.5,2016-17
467,2199,Tyson Chandler,1610612756,PHX,45,14,31,1229.0,138,95,40,0.688,310,0.445,10,0.46,5.4,367,114,250,0.311,538,0.682,35,0.73,4.2,505,209,290,0.414,845,0.598,45,0.631,4.5,2016-17
468,1626145,Tyus Jones,1610612750,MIN,60,23,37,774.0,10,2,8,0.2,48,0.208,1,0.213,17.2,57,4,53,0.07,93,0.613,3,0.633,11.9,67,6,61,0.09,141,0.475,4,0.489,12.7,2016-17
469,2617,Udonis Haslem,1610612748,MIA,16,6,10,130.0,8,6,2,0.75,25,0.32,0,0.32,9.4,28,9,17,0.321,45,0.622,9,0.778,4.1,36,15,19,0.417,70,0.514,9,0.59,5.4,2016-17
470,203506,Victor Oladipo,1610612760,OKC,67,39,28,2223.0,39,11,27,0.282,149,0.262,5,0.271,14.9,252,37,216,0.147,474,0.532,56,0.603,7.1,291,48,243,0.165,622,0.468,61,0.519,8.1,2016-17
471,1713,Vince Carter,1610612763,MEM,73,36,37,1800.0,36,20,15,0.556,147,0.245,1,0.247,8.9,191,46,146,0.241,374,0.511,33,0.56,7.0,227,66,161,0.291,520,0.437,34,0.467,7.3,2016-17
472,1627735,Wade Baldwin IV,1610612763,MEM,33,18,15,405.0,11,5,6,0.455,40,0.275,2,0.289,10.6,35,4,31,0.114,75,0.467,10,0.538,7.4,46,9,37,0.196,115,0.4,12,0.447,8.1,2016-17
473,201961,Wayne Ellington,1610612748,MIA,62,35,27,1500.0,18,5,14,0.278,85,0.212,2,0.217,15.9,114,17,95,0.149,220,0.518,14,0.553,8.0,132,22,109,0.167,305,0.433,16,0.457,9.2,2016-17
474,1627782,Wayne Selden,1610612763,MEM,14,6,8,236.0,1,0,1,0.0,10,0.1,0,0.1,6.0,15,5,10,0.333,33,0.455,2,0.484,9.9,16,5,11,0.313,43,0.372,2,0.39,9.7,2016-17
475,202325,Wesley Johnson,1610612746,LAC,68,40,28,810.0,26,6,19,0.231,55,0.473,0,0.473,13.9,155,42,113,0.271,261,0.594,18,0.638,5.8,181,48,132,0.265,315,0.575,18,0.609,6.9,2016-17
476,202083,Wesley Matthews,1610612742,DAL,72,28,44,2457.0,18,3,15,0.167,117,0.154,5,0.161,16.4,241,41,201,0.17,443,0.544,34,0.589,7.6,259,44,216,0.17,559,0.463,39,0.498,8.2,2016-17
477,203115,Will Barton,1610612743,DEN,59,30,29,1681.0,55,24,29,0.436,185,0.297,7,0.309,10.5,197,32,165,0.162,372,0.53,33,0.581,5.9,252,56,194,0.222,557,0.452,40,0.487,6.9,2016-17
478,1626161,Willie Cauley-Stein,1610612758,SAC,75,29,46,1421.0,85,55,28,0.647,204,0.417,9,0.436,6.8,254,93,159,0.366,410,0.62,23,0.656,5.4,339,148,187,0.437,614,0.552,32,0.582,5.7,2016-17
479,203186,Willie Reed,1610612748,MIA,71,39,32,1031.0,129,98,32,0.76,253,0.51,3,0.516,4.8,203,81,124,0.399,377,0.538,37,0.597,4.5,332,179,156,0.539,630,0.527,40,0.563,4.6,2016-17
480,1626195,Willy Hernangomez,1610612752,NYK,72,27,45,1324.0,170,107,49,0.629,385,0.442,7,0.45,5.7,332,121,211,0.364,528,0.629,49,0.693,4.0,502,228,260,0.454,912,0.55,56,0.586,4.6,2016-17
481,201163,Wilson Chandler,1610612743,DEN,70,34,36,2165.0,103,67,30,0.65,243,0.424,7,0.436,6.9,350,94,256,0.269,566,0.618,48,0.676,5.6,453,161,286,0.355,806,0.562,55,0.603,5.9,2016-17
482,1627812,Yogi Ferrell,1610612742,DAL,46,18,28,1197.0,20,7,14,0.35,89,0.225,5,0.238,13.6,91,14,77,0.154,200,0.455,19,0.503,9.5,111,21,91,0.189,289,0.384,24,0.419,10.4,2016-17
483,203897,Zach LaVine,1610612750,MIN,47,16,31,1749.0,19,2,15,0.105,117,0.162,7,0.173,19.2,141,12,131,0.085,267,0.528,22,0.576,8.3,160,14,146,0.088,384,0.417,29,0.451,9.5,2016-17
484,2216,Zach Randolph,1610612763,MEM,73,38,35,1786.0,182,131,47,0.72,465,0.391,13,0.403,4.9,416,137,278,0.329,598,0.696,49,0.758,4.6,598,268,325,0.448,1058,0.565,62,0.6,4.7,2016-17
485,2585,Zaza Pachulia,1610612744,GSW,70,58,12,1268.0,140,91,45,0.65,322,0.435,6,0.443,6.1,270,102,169,0.378,489,0.552,52,0.618,4.8,410,193,214,0.471,810,0.506,58,0.545,5.3,2016-17
0,201166,Aaron Brooks,1610612750,MIN,32,19,13,189.0,7,1,6,0.143,16,0.438,1,0.467,18.7,10,2,9,0.2,20,0.5,5,0.667,7.2,17,3,15,0.176,36,0.472,6,0.567,11.5,2017-18
1,203932,Aaron Gordon,1610612753,ORL,58,19,39,1909.0,87,58,26,0.667,260,0.335,5,0.341,7.9,370,95,276,0.257,576,0.642,34,0.683,5.6,457,153,302,0.335,787,0.581,39,0.611,6.0,2017-18
2,1626151,Aaron Harrison,1610612742,DAL,9,2,7,233.0,4,1,3,0.25,6,0.667,0,0.667,13.3,20,2,18,0.1,36,0.556,2,0.588,10.5,24,3,21,0.125,42,0.571,2,0.6,11.0,2017-18
3,1628935,Aaron Jackson,1610612745,HOU,1,0,1,35.0,2,1,1,0.5,5,0.4,0,0.4,4.8,1,0,1,0.0,2,0.5,0,0.5,13.8,3,1,2,0.333,7,0.429,0,0.429,7.8,2017-18
4,1627846,Abdel Nader,1610612738,BOS,47,32,15,520.0,13,7,6,0.538,42,0.31,1,0.317,6.4,58,14,44,0.241,85,0.682,8,0.753,7.2,71,21,50,0.296,123,0.577,9,0.623,7.0,2017-18
5,203940,Adreian Payne,1610612753,ORL,5,0,5,43.0,2,1,1,0.5,5,0.4,0,0.4,6.0,7,2,5,0.286,11,0.636,0,0.636,4.2,9,3,6,0.333,16,0.563,0,0.563,4.6,2017-18
6,201143,Al Horford,1610612738,BOS,69,44,25,2175.0,100,58,42,0.58,258,0.388,2,0.391,8.3,408,114,287,0.279,653,0.625,39,0.664,5.9,508,172,329,0.339,879,0.578,41,0.606,6.4,2017-18
7,2744,Al Jefferson,1610612754,IND,36,17,19,484.0,30,23,7,0.767,96,0.313,0,0.313,4.9,113,37,76,0.327,186,0.608,13,0.653,4.4,143,60,83,0.42,269,0.532,13,0.559,4.5,2017-18
8,202329,Al-Farouq Aminu,1610612757,POR,69,40,29,2072.0,97,41,53,0.423,261,0.372,4,0.377,8.9,428,112,307,0.262,672,0.637,41,0.678,5.2,525,153,360,0.291,887,0.592,45,0.624,5.9,2017-18
9,1626210,Alan Williams,1610612756,PHX,5,1,4,70.0,3,1,1,0.333,20,0.15,0,0.15,9.8,19,5,14,0.263,31,0.613,0,0.613,3.4,22,6,15,0.273,48,0.458,0,0.458,4.0,2017-18
10,202692,Alec Burks,1610612762,UTA,64,37,27,1059.0,19,14,5,0.737,94,0.202,5,0.213,11.1,173,32,142,0.185,277,0.625,21,0.676,6.0,192,46,147,0.24,360,0.533,26,0.575,6.5,2017-18
11,1628409,Alec Peters,1610612756,PHX,20,2,18,225.0,8,7,1,0.875,21,0.381,2,0.421,5.0,29,7,23,0.241,42,0.69,2,0.725,5.7,37,14,24,0.378,59,0.627,4,0.673,5.6,2017-18
12,203518,Alex Abrines,1610612760,OKC,73,42,31,1100.0,25,11,13,0.44,66,0.379,3,0.397,12.3,86,19,65,0.221,176,0.489,16,0.538,8.5,111,30,78,0.27,239,0.464,19,0.505,9.4,2017-18
13,1627936,Alex Caruso,1610612747,LAL,37,16,21,562.0,15,8,7,0.533,41,0.366,4,0.405,11.2,50,6,44,0.12,88,0.568,7,0.617,10.1,65,14,51,0.215,124,0.524,11,0.575,10.4,2017-18
14,203458,Alex Len,1610612756,PHX,69,20,49,1395.0,175,117,53,0.669,420,0.417,7,0.424,5.0,343,123,221,0.359,588,0.583,31,0.616,4.1,518,240,274,0.463,965,0.537,38,0.559,4.4,2017-18
15,1627816,Alex Poythress,1610612754,IND,25,10,15,104.0,7,6,1,0.857,22,0.318,1,0.333,5.0,10,2,8,0.2,16,0.625,0,0.625,8.6,17,8,9,0.471,37,0.459,1,0.472,7.2,2017-18
16,1628035,Alfonzo McKinnie,1610612761,TOR,14,13,1,53.0,1,1,0,1.0,2,0.5,0,0.5,1.2,6,3,3,0.5,11,0.545,3,0.75,3.6,7,4,3,0.571,12,0.583,3,0.778,3.2,2017-18
17,203459,Allen Crabbe,1610612751,BKN,73,24,49,2133.0,27,11,16,0.407,139,0.194,6,0.203,13.4,288,49,238,0.17,457,0.63,22,0.662,6.8,315,60,254,0.19,579,0.544,28,0.572,7.3,2017-18
18,101161,Amir Johnson,1610612755,PHI,74,47,27,1170.0,123,92,28,0.748,290,0.424,8,0.436,5.7,207,77,130,0.372,410,0.505,52,0.578,5.4,330,169,158,0.512,683,0.483,60,0.53,5.5,2017-18
19,203083,Andre Drummond,1610612765,DET,78,37,41,2625.0,399,274,119,0.687,831,0.48,18,0.491,5.1,848,300,544,0.354,1239,0.684,61,0.72,3.5,1247,574,663,0.46,2001,0.623,79,0.649,4.0,2017-18
20,2738,Andre Iguodala,1610612744,GSW,64,46,18,1622.0,50,16,34,0.32,134,0.373,8,0.397,10.6,196,42,153,0.214,369,0.531,28,0.575,7.6,246,58,187,0.236,487,0.505,36,0.545,8.2,2017-18
21,201281,Andre Ingram,1610612747,LAL,2,1,1,64.0,1,0,1,0.0,1,1.0,0,1.0,8.2,5,0,5,0.0,7,0.714,1,0.833,10.6,6,0,6,0.0,8,0.75,1,0.857,10.2,2017-18
22,203460,Andre Roberson,1610612760,OKC,37,24,13,983.0,68,46,19,0.676,167,0.407,5,0.42,7.1,104,28,75,0.269,199,0.523,17,0.571,6.2,172,74,94,0.43,362,0.475,22,0.506,6.5,2017-18
23,101106,Andrew Bogut,1610612747,LAL,24,7,17,216.0,26,19,7,0.731,52,0.5,2,0.52,6.2,52,17,35,0.327,81,0.642,6,0.693,4.7,78,36,42,0.462,126,0.619,8,0.661,5.2,2017-18
24,1626150,Andrew Harrison,1610612763,MEM,56,17,39,1326.0,23,3,20,0.13,121,0.19,4,0.197,11.7,108,18,92,0.167,213,0.507,19,0.557,9.6,131,21,112,0.16,327,0.401,23,0.431,10.0,2017-18
25,1628510,Andrew White III,1610612737,ATL,15,1,14,209.0,4,2,2,0.5,18,0.222,0,0.222,4.9,30,1,27,0.033,51,0.588,4,0.638,7.9,34,3,29,0.088,68,0.5,4,0.531,7.5,2017-18
26,203952,Andrew Wiggins,1610612750,MIN,82,47,35,2979.0,82,45,35,0.549,300,0.273,7,0.28,8.8,276,62,215,0.225,522,0.529,44,0.577,6.5,358,107,250,0.299,818,0.438,51,0.467,7.0,2017-18
27,1627790,Ante Zizic,1610612739,CLE,32,21,11,214.0,24,20,5,0.833,56,0.429,2,0.444,4.2,36,10,25,0.278,67,0.537,5,0.581,5.0,60,30,30,0.5,117,0.513,7,0.545,4.7,2017-18
28,1626148,Anthony Brown,1610612750,MIN,1,0,1,4.0,0,0,0,0.0,0,0.0,0,0.0,0.0,0,0,0,0.0,0,0.0,2,0.0,0.0,0,0,0,0.0,0,0.0,2,0.0,0.0,2017-18
29,203076,Anthony Davis,1610612740,NOP,75,45,30,2727.0,187,125,58,0.668,432,0.433,9,0.442,6.5,644,218,427,0.339,997,0.646,51,0.681,4.8,831,343,485,0.413,1401,0.593,60,0.62,5.2,2017-18
30,201229,Anthony Tolliver,1610612765,DET,79,37,42,1757.0,50,16,32,0.32,131,0.382,2,0.388,9.8,191,50,141,0.262,421,0.454,39,0.5,7.5,241,66,173,0.274,533,0.452,41,0.49,8.0,2017-18
31,1628469,Antonio Blakeney,1610612741,CHI,19,3,16,314.0,4,2,2,0.5,13,0.308,0,0.308,12.9,29,2,26,0.069,56,0.518,4,0.558,6.3,33,4,28,0.121,69,0.478,4,0.508,7.1,2017-18
32,1628499,Antonius Cleveland,1610612737,ATL,17,7,10,123.0,3,2,1,0.667,12,0.25,1,0.273,6.3,11,3,8,0.273,19,0.579,2,0.647,7.3,14,5,9,0.357,31,0.452,3,0.5,7.1,2017-18
33,203382,Aron Baynes,1610612738,BOS,78,51,27,1433.0,128,88,38,0.688,330,0.388,6,0.395,5.0,292,103,186,0.353,546,0.535,57,0.597,4.5,420,191,224,0.455,851,0.494,63,0.533,4.6,2017-18
34,201167,Arron Afflalo,1610612753,ORL,53,16,37,682.0,4,0,4,0.0,34,0.118,0,0.118,17.9,62,13,47,0.21,100,0.62,12,0.705,8.7,66,13,51,0.197,129,0.512,12,0.564,9.3,2017-18
35,203085,Austin Rivers,1610612746,LAC,61,30,31,2057.0,27,9,20,0.333,124,0.218,7,0.231,12.9,118,18,99,0.153,266,0.444,32,0.504,8.4,145,27,119,0.186,384,0.378,39,0.42,9.4,2017-18
36,202340,Avery Bradley,1610612746,LAC,46,22,24,1433.0,22,11,11,0.5,107,0.206,8,0.222,8.1,94,10,84,0.106,169,0.556,20,0.631,7.3,116,21,95,0.181,273,0.425,28,0.473,7.5,2017-18
37,1628389,Bam Adebayo,1610612748,MIA,68,33,35,1348.0,116,79,37,0.681,282,0.411,5,0.419,6.4,260,83,177,0.319,416,0.625,26,0.667,5.5,376,162,214,0.431,663,0.567,31,0.595,5.8,2017-18
38,203463,Ben McLemore,1610612763,MEM,56,7,49,1091.0,34,15,18,0.441,108,0.315,0,0.315,9.4,105,8,96,0.076,197,0.533,28,0.621,7.6,139,23,114,0.165,296,0.47,28,0.519,8.0,2017-18
39,1628500,Ben Moore,1610612754,IND,2,1,1,9.0,0,0,0,0.0,0,0.0,0,0.0,0.0,1,0,1,0.0,2,0.5,0,0.5,9.7,1,0,1,0.0,2,0.5,0,0.5,9.7,2017-18
40,1627732,Ben Simmons,1610612755,PHI,80,51,29,2703.0,145,71,72,0.49,413,0.351,9,0.359,10.1,512,101,408,0.197,777,0.659,35,0.69,6.6,657,172,480,0.262,1110,0.592,44,0.616,7.4,2017-18
41,202687,Bismack Biyombo,1610612753,ORL,82,25,57,1495.0,144,97,44,0.674,381,0.378,8,0.386,5.2,324,105,217,0.324,582,0.557,35,0.592,4.3,468,202,261,0.432,935,0.501,43,0.525,4.6,2017-18
42,201933,Blake Griffin,1610612765,DET,58,28,30,1970.0,73,46,28,0.63,269,0.271,12,0.284,8.5,355,84,267,0.237,598,0.594,39,0.635,4.7,428,130,295,0.304,831,0.515,51,0.549,5.4,2017-18
43,1626246,Boban Marjanovic,1610612746,LAC,39,18,21,338.0,48,38,10,0.792,110,0.436,4,0.453,3.2,96,35,61,0.365,151,0.636,14,0.701,3.8,144,73,71,0.507,253,0.569,18,0.613,3.6,2017-18
44,201628,Bobby Brown,1610612745,HOU,20,17,3,115.0,0,0,1,0.0,1,0.0,0,0.0,0.0,7,0,7,0.0,11,0.636,1,0.7,16.3,7,0,8,0.0,11,0.636,1,0.7,16.2,2017-18
45,1626171,Bobby Portis,1610612741,CHI,73,25,48,1642.0,159,102,50,0.642,373,0.426,5,0.432,5.7,339,66,273,0.195,541,0.627,34,0.669,4.8,498,168,323,0.337,883,0.564,39,0.59,5.1,2017-18
46,203992,Bogdan Bogdanovic,1610612758,SAC,78,26,52,2175.0,31,19,12,0.613,138,0.225,5,0.233,8.1,192,37,154,0.193,365,0.526,38,0.587,7.5,223,56,166,0.251,492,0.453,43,0.497,7.6,2017-18
47,202711,Bojan Bogdanovic,1610612754,IND,80,47,33,2464.0,30,7,23,0.233,155,0.194,6,0.201,15.3,240,36,201,0.15,395,0.608,25,0.649,7.1,270,43,224,0.159,528,0.511,31,0.543,8.0,2017-18
48,203078,Bradley Beal,1610612764,WAS,82,43,39,2977.0,61,27,34,0.443,254,0.24,10,0.25,12.3,302,57,242,0.189,521,0.58,28,0.613,8.1,363,84,276,0.231,757,0.48,38,0.505,8.8,2017-18
49,201148,Brandan Wright,1610612763,MEM,28,11,17,381.0,33,21,12,0.636,65,0.508,2,0.524,5.5,62,29,33,0.468,120,0.517,7,0.549,5.6,95,50,45,0.526,179,0.531,9,0.559,5.6,2017-18
50,1627742,Brandon Ingram,1610612747,LAL,59,27,32,1975.0,57,33,23,0.579,209,0.273,7,0.282,8.4,257,57,201,0.222,417,0.616,26,0.657,6.5,314,90,224,0.287,619,0.507,33,0.536,6.8,2017-18
51,201943,Brandon Jennings,1610612749,MIL,14,8,6,205.0,5,2,3,0.4,15,0.333,0,0.333,12.6,26,1,25,0.038,47,0.553,2,0.578,8.6,31,3,28,0.097,61,0.508,2,0.525,9.2,2017-18
52,203464,Brandon Paul,1610612759,SAS,64,38,26,576.0,6,2,4,0.333,33,0.182,1,0.188,8.6,62,11,51,0.177,119,0.521,11,0.574,8.0,68,13,55,0.191,147,0.463,12,0.504,8.1,2017-18
53,1627362,Briante Weber,1610612763,MEM,18,8,10,237.0,8,0,8,0.0,22,0.364,1,0.381,18.3,27,5,22,0.185,43,0.628,2,0.659,7.6,35,5,30,0.143,65,0.538,3,0.565,10.1,2017-18
54,1627744,Brice Johnson,1610612746,LAC,18,2,16,98.0,9,5,3,0.556,22,0.409,0,0.409,7.3,22,9,10,0.409,27,0.815,1,0.846,3.7,31,14,13,0.452,44,0.705,1,0.721,4.8,2017-18
55,201572,Brook Lopez,1610612747,LAL,74,34,40,1735.0,74,47,25,0.635,158,0.468,1,0.471,7.3,220,99,115,0.45,428,0.514,35,0.56,6.1,294,146,140,0.497,573,0.513,36,0.547,6.4,2017-18
56,203998,Bruno Caboclo,1610612758,SAC,12,4,8,106.0,7,6,1,0.857,20,0.35,0,0.35,6.2,15,5,10,0.333,31,0.484,4,0.556,5.4,22,11,11,0.5,47,0.468,4,0.512,5.6,2017-18
57,1627854,Bryn Forbes,1610612759,SAS,80,46,34,1517.0,12,2,11,0.167,49,0.245,1,0.25,16.4,98,14,84,0.143,198,0.495,23,0.56,9.6,110,16,95,0.145,243,0.453,24,0.502,10.5,2017-18
58,1627741,Buddy Hield,1610612758,SAC,80,27,53,2024.0,55,18,36,0.327,177,0.311,6,0.322,11.2,252,25,225,0.099,438,0.575,35,0.625,7.1,307,43,261,0.14,611,0.502,41,0.539,7.8,2017-18
59,203710,C.J. Williams,1610612746,LAC,38,17,21,707.0,12,4,8,0.333,39,0.308,2,0.324,9.5,44,9,35,0.205,88,0.5,9,0.557,9.7,56,13,43,0.232,126,0.444,11,0.487,9.7,2017-18
60,203468,CJ McCollum,1610612757,POR,81,48,33,2924.0,53,22,30,0.415,236,0.225,12,0.237,11.5,268,38,229,0.142,469,0.571,31,0.612,9.9,321,60,259,0.187,697,0.461,43,0.491,10.2,2017-18
61,101139,CJ Miles,1610612761,TOR,70,50,20,1337.0,18,7,12,0.389,71,0.254,6,0.277,16.0,134,24,110,0.179,225,0.596,7,0.615,9.1,152,31,122,0.204,287,0.53,13,0.555,9.9,2017-18
62,1628403,Caleb Swanigan,1610612757,POR,27,16,11,189.0,15,13,2,0.867,55,0.273,1,0.278,3.4,39,10,29,0.256,64,0.609,8,0.696,4.4,54,23,31,0.426,114,0.474,9,0.514,4.1,2017-18
63,1626166,Cameron Payne,1610612741,CHI,25,7,18,582.0,18,8,10,0.444,71,0.254,2,0.261,13.6,51,4,47,0.078,90,0.567,8,0.622,8.6,69,12,57,0.174,154,0.448,10,0.479,9.9,2017-18
64,1627747,Caris LeVert,1610612751,BKN,69,24,45,1802.0,53,28,26,0.528,219,0.242,17,0.262,8.1,202,38,165,0.188,339,0.596,25,0.643,6.8,255,66,191,0.259,552,0.462,42,0.5,7.0,2017-18
65,2546,Carmelo Anthony,1610612760,OKC,76,46,30,2432.0,64,38,27,0.594,212,0.302,9,0.315,10.2,373,75,297,0.201,657,0.568,38,0.603,5.3,437,113,324,0.259,832,0.525,47,0.557,6.0,2017-18
66,1626224,Cedi Osman,1610612739,CLE,61,35,26,672.0,19,8,10,0.421,84,0.226,3,0.235,10.1,101,14,86,0.139,145,0.697,13,0.765,6.0,120,22,96,0.183,210,0.571,16,0.619,6.7,2017-18
67,202718,Chandler Parsons,1610612763,MEM,36,12,24,691.0,14,5,9,0.357,57,0.246,2,0.255,9.0,76,10,65,0.132,130,0.585,9,0.628,6.9,90,15,74,0.167,176,0.511,11,0.545,7.3,2017-18
68,101112,Channing Frye,1610612747,LAL,53,28,25,695.0,12,9,3,0.75,33,0.364,2,0.387,9.9,123,37,86,0.301,227,0.542,22,0.6,4.8,135,46,89,0.341,250,0.54,24,0.597,5.2,2017-18
69,1628429,Charles Cooke,1610612740,NOP,13,8,5,38.0,0,0,0,0.0,0,0.0,1,0.0,0.0,2,1,1,0.5,2,1.0,0,1.0,7.2,2,1,1,0.5,2,1.0,1,2.0,7.2,2017-18
70,1627767,Cheick Diallo,1610612740,NOP,52,29,23,581.0,47,30,15,0.638,147,0.32,2,0.324,6.5,164,46,113,0.28,268,0.612,14,0.646,4.2,211,76,128,0.36,395,0.534,16,0.557,4.7,2017-18
71,1627778,Chinanu Onuaku,1610612745,HOU,1,0,1,22.0,1,1,0,1.0,6,0.167,0,0.167,12.7,3,1,2,0.333,7,0.429,1,0.5,3.8,4,2,2,0.5,13,0.308,1,0.333,6.1,2017-18
72,1628449,Chris Boucher,1610612744,GSW,1,1,0,1.0,0,0,0,0.0,1,0.0,0,0.0,0.0,1,0,1,0.0,1,1.0,0,1.0,0.9,1,0,1,0.0,1,1.0,0,1.0,0.9,2017-18
73,1626191,Chris McCullough,1610612764,WAS,19,11,8,90.0,7,4,3,0.571,20,0.35,1,0.368,9.4,18,3,15,0.167,27,0.667,5,0.818,4.2,25,7,18,0.28,45,0.556,6,0.641,5.7,2017-18
74,101108,Chris Paul,1610612745,HOU,58,50,8,1847.0,37,8,27,0.216,121,0.306,3,0.314,13.4,276,45,232,0.163,506,0.545,45,0.599,7.1,313,53,259,0.169,619,0.506,48,0.548,7.8,2017-18
75,203991,Clint Capela,1610612745,HOU,74,62,12,2034.0,241,158,80,0.656,509,0.473,8,0.481,6.4,561,167,390,0.298,856,0.655,50,0.696,4.4,802,325,470,0.405,1343,0.597,58,0.624,5.0,2017-18
76,203469,Cody Zeller,1610612766,CHA,33,14,19,627.0,67,48,19,0.716,186,0.36,2,0.364,4.6,110,43,67,0.391,193,0.57,12,0.608,5.3,177,91,86,0.514,375,0.472,14,0.49,5.0,2017-18
77,202332,Cole Aldrich,1610612750,MIN,21,14,7,49.0,3,2,1,0.667,14,0.214,0,0.214,3.0,12,2,10,0.167,15,0.8,2,0.923,2.8,15,4,11,0.267,25,0.6,2,0.652,2.9,2017-18
78,201147,Corey Brewer,1610612760,OKC,72,32,40,1209.0,43,14,29,0.326,139,0.309,3,0.316,10.7,111,22,87,0.198,194,0.572,22,0.645,7.8,154,36,116,0.234,328,0.47,25,0.508,8.6,2017-18
79,202709,Cory Joseph,1610612754,IND,82,48,34,2210.0,39,7,31,0.179,124,0.315,4,0.325,14.0,224,42,185,0.188,425,0.527,36,0.576,8.4,263,49,216,0.186,541,0.486,40,0.525,9.2,2017-18
80,201584,Courtney Lee,1610612752,NYK,75,26,49,2278.0,29,11,18,0.379,106,0.274,2,0.279,11.6,190,26,163,0.137,319,0.596,23,0.642,9.9,219,37,181,0.169,420,0.521,25,0.554,10.1,2017-18
81,1626245,Cristiano Felicio,1610612741,CHI,55,13,42,977.0,83,61,21,0.735,242,0.343,6,0.352,5.4,150,50,100,0.333,264,0.568,24,0.625,4.8,233,111,121,0.476,494,0.472,30,0.502,5.0,2017-18
82,1626156,D'Angelo Russell,1610612751,BKN,48,16,32,1234.0,30,11,20,0.367,95,0.316,3,0.326,13.3,159,18,139,0.113,265,0.6,15,0.636,7.0,189,29,159,0.153,347,0.545,18,0.574,8.0,2017-18
83,201571,D.J. Augustin,1610612753,ORL,75,23,52,1760.0,30,4,24,0.133,134,0.224,3,0.229,15.1,130,13,116,0.1,255,0.51,26,0.568,10.4,160,17,140,0.106,379,0.422,29,0.457,11.3,2017-18
84,1628391,D.J. Wilson,1610612749,MIL,22,12,10,71.0,2,0,2,0.0,4,0.5,0,0.5,13.0,8,2,6,0.25,9,0.889,0,0.889,4.7,10,2,8,0.2,12,0.833,0,0.833,6.4,2017-18
85,1626177,Dakari Johnson,1610612760,OKC,30,21,9,148.0,16,11,5,0.688,38,0.421,2,0.444,6.0,15,6,9,0.4,39,0.385,4,0.429,8.5,31,17,14,0.548,76,0.408,6,0.443,7.2,2017-18
86,1627745,Damian Jones,1610612744,GSW,15,7,8,89.0,5,5,0,1.0,16,0.313,0,0.313,5.6,9,3,6,0.333,25,0.36,5,0.45,4.7,14,8,6,0.571,40,0.35,5,0.4,5.0,2017-18
87,203081,Damian Lillard,1610612757,POR,73,44,29,2670.0,62,20,41,0.323,241,0.257,11,0.27,13.5,263,33,227,0.125,465,0.566,29,0.603,8.5,325,53,268,0.163,701,0.464,40,0.492,9.5,2017-18
88,2863,Damien Wilkins,1610612754,IND,19,10,9,152.0,5,4,1,0.8,13,0.385,1,0.417,9.2,11,1,10,0.091,17,0.647,2,0.733,6.3,16,5,11,0.313,29,0.552,3,0.615,7.2,2017-18
89,1627814,Damion Lee,1610612737,ATL,15,4,11,404.0,11,3,8,0.273,46,0.239,2,0.25,9.8,60,7,53,0.117,93,0.645,4,0.674,7.1,71,10,61,0.141,139,0.511,6,0.534,7.6,2017-18
90,1628422,Damyean Dotson,1610612752,NYK,44,11,33,474.0,9,1,8,0.111,27,0.333,0,0.333,15.5,75,11,64,0.147,108,0.694,5,0.728,6.7,84,12,72,0.143,132,0.636,5,0.661,7.6,2017-18
91,1627772,Daniel Hamilton,1610612760,OKC,6,5,1,28.0,0,0,0,0.0,5,0.0,1,0.0,0.0,5,0,5,0.0,9,0.556,1,0.625,3.8,5,0,5,0.0,13,0.385,2,0.455,3.8,2017-18
92,1628464,Daniel Theis,1610612738,BOS,60,41,19,894.0,86,61,25,0.709,206,0.417,2,0.422,6.4,173,84,89,0.486,308,0.562,31,0.625,4.2,259,145,114,0.56,487,0.532,33,0.57,5.0,2017-18
93,201568,Danilo Gallinari,1610612746,LAC,21,11,10,671.0,9,4,5,0.444,52,0.173,3,0.184,9.9,92,23,69,0.25,156,0.59,14,0.648,6.7,101,27,74,0.267,206,0.49,17,0.534,7.0,2017-18
94,201980,Danny Green,1610612759,SAS,70,40,30,1791.0,41,17,24,0.415,129,0.318,4,0.328,11.3,208,35,174,0.168,397,0.524,34,0.573,6.0,249,52,198,0.209,517,0.482,38,0.52,6.9,2017-18
95,201967,Dante Cunningham,1610612751,BKN,73,34,39,1562.0,78,42,35,0.538,218,0.358,3,0.363,6.8,220,58,160,0.264,413,0.533,28,0.571,6.0,298,100,195,0.336,601,0.496,31,0.523,6.3,2017-18
96,203957,Dante Exum,1610612762,UTA,14,10,4,235.0,4,3,1,0.75,17,0.235,1,0.25,5.8,22,4,18,0.182,49,0.449,0,0.449,5.5,26,7,19,0.269,66,0.394,1,0.4,5.6,2017-18
97,1627863,Danuel House Jr.,1610612756,PHX,23,6,17,403.0,13,7,6,0.538,37,0.351,0,0.351,8.3,63,8,55,0.127,91,0.692,7,0.75,7.3,76,15,61,0.197,127,0.598,7,0.633,7.4,2017-18
98,203967,Dario Saric,1610612755,PHI,77,49,28,2276.0,152,92,57,0.605,387,0.393,13,0.406,7.1,364,85,279,0.234,703,0.518,61,0.567,5.0,516,177,336,0.343,1051,0.491,74,0.528,5.6,2017-18
99,203121,Darius Miller,1610612740,NOP,82,48,34,1944.0,18,5,12,0.278,40,0.45,3,0.486,16.5,146,36,109,0.247,292,0.5,33,0.564,8.7,164,41,121,0.25,327,0.502,36,0.564,9.5,2017-18
100,201589,Darrell Arthur,1610612743,DEN,19,12,7,141.0,3,2,1,0.667,10,0.3,1,0.333,7.3,12,7,5,0.583,28,0.429,4,0.5,4.4,15,9,6,0.6,36,0.417,5,0.484,5.0,2017-18
101,201954,Darren Collison,1610612754,IND,69,39,30,2018.0,37,5,33,0.135,109,0.339,3,0.349,16.4,141,12,126,0.085,264,0.534,17,0.571,11.1,178,17,159,0.096,369,0.482,20,0.51,12.2,2017-18
102,1626199,Darrun Hilliard,1610612759,SAS,14,8,6,95.0,0,0,0,0.0,5,0.0,0,0.0,0.0,7,2,5,0.286,15,0.467,2,0.538,7.5,7,2,5,0.286,20,0.35,2,0.389,7.5,2017-18
103,1628021,David Nwaba,1610612741,CHI,70,26,44,1646.0,89,46,41,0.517,271,0.328,11,0.342,7.8,237,44,193,0.186,431,0.55,42,0.609,6.9,326,90,234,0.276,683,0.477,53,0.517,7.1,2017-18
104,204065,David Stockton,1610612762,UTA,3,3,0,9.0,0,0,0,0.0,0,0.0,0,0.0,0.0,0,0,0,0.0,0,0.0,1,0.0,0.0,0,0,0,0.0,0,0.0,1,0.0,0.0,2017-18
105,2561,David West,1610612744,GSW,73,52,21,999.0,64,42,21,0.656,141,0.454,3,0.464,6.8,174,68,106,0.391,319,0.545,38,0.619,5.3,238,110,127,0.462,450,0.529,41,0.582,5.7,2017-18
106,202722,Davis Bertans,1610612759,SAS,77,43,34,1086.0,18,13,5,0.722,52,0.346,3,0.367,6.1,135,42,93,0.311,263,0.513,17,0.549,5.4,153,55,98,0.359,306,0.5,20,0.535,5.5,2017-18
107,1628432,Davon Reed,1610612756,PHX,21,2,19,242.0,2,0,2,0.0,17,0.118,0,0.118,17.6,37,3,33,0.081,63,0.587,7,0.661,5.9,39,3,35,0.077,78,0.5,7,0.549,6.5,2017-18
108,1628368,De'Aaron Fox,1610612758,SAC,73,24,49,2026.0,33,15,18,0.455,147,0.224,6,0.234,12.2,171,19,153,0.111,327,0.523,23,0.563,9.0,204,34,171,0.167,470,0.434,29,0.463,9.5,2017-18
109,201599,DeAndre Jordan,1610612746,LAC,77,39,38,2423.0,329,229,101,0.696,707,0.465,8,0.471,5.0,842,208,631,0.247,1197,0.703,53,0.736,4.5,1171,437,732,0.373,1841,0.636,61,0.658,4.6,2017-18
110,202732,DeAndre Liggins,1610612740,NOP,57,34,23,708.0,7,2,5,0.286,31,0.226,3,0.25,13.5,67,20,45,0.299,110,0.609,12,0.684,6.5,74,22,50,0.297,140,0.529,15,0.592,7.1,2017-18
111,1627761,DeAndre' Bembry,1610612737,ATL,25,8,17,454.0,8,3,5,0.375,34,0.235,2,0.25,14.0,64,14,50,0.219,108,0.593,7,0.634,7.3,72,17,55,0.236,141,0.511,9,0.545,8.1,2017-18
112,201942,DeMar DeRozan,1610612761,TOR,80,57,23,2712.0,59,19,40,0.322,234,0.252,11,0.265,10.5,256,39,216,0.152,428,0.598,28,0.64,8.9,315,58,256,0.184,646,0.488,39,0.519,9.2,2017-18
113,202326,DeMarcus Cousins,1610612740,NOP,48,27,21,1737.0,105,75,27,0.714,285,0.368,4,0.374,5.9,512,170,343,0.332,768,0.667,35,0.698,4.2,617,245,370,0.397,1010,0.611,39,0.635,4.5,2017-18
114,201960,DeMarre Carroll,1610612751,BKN,71,24,47,2122.0,103,56,48,0.544,332,0.31,13,0.323,9.0,360,84,276,0.233,624,0.577,45,0.622,6.1,463,140,324,0.302,925,0.501,58,0.534,6.8,2017-18
115,1627749,Dejounte Murray,1610612759,SAS,81,47,34,1743.0,110,54,54,0.491,302,0.364,11,0.378,8.3,349,60,289,0.172,595,0.587,43,0.632,5.7,459,114,343,0.248,884,0.519,54,0.553,6.4,2017-18
116,1626153,Delon Wright,1610612761,TOR,69,49,20,1433.0,45,18,27,0.4,165,0.273,7,0.285,7.9,153,18,133,0.118,284,0.539,21,0.582,8.2,198,36,160,0.182,443,0.447,28,0.477,8.1,2017-18
117,1627743,Demetrius Jackson,1610612755,PHI,15,12,3,80.0,5,2,3,0.4,7,0.714,0,0.714,12.7,7,1,6,0.143,11,0.636,3,0.875,8.2,12,3,9,0.25,18,0.667,3,0.8,10.1,2017-18
118,203471,Dennis Schroder,1610612737,ATL,66,21,45,2041.0,43,10,33,0.233,213,0.202,7,0.209,14.2,163,15,148,0.092,312,0.522,27,0.572,9.2,206,25,181,0.121,521,0.395,34,0.423,10.2,2017-18
119,1628372,Dennis Smith Jr.,1610612742,DAL,69,22,47,2049.0,50,20,29,0.4,259,0.193,12,0.202,10.1,210,34,177,0.162,422,0.498,38,0.547,7.5,260,54,206,0.208,677,0.384,50,0.415,8.0,2017-18
120,1627756,Denzel Valentine,1610612741,CHI,77,26,51,2095.0,48,17,31,0.354,154,0.312,3,0.318,13.6,345,63,282,0.183,585,0.59,53,0.648,6.0,393,80,313,0.204,725,0.542,56,0.587,6.9,2017-18
121,202324,Derrick Favors,1610612762,UTA,77,46,31,2153.0,198,141,52,0.712,467,0.424,9,0.432,4.9,354,135,218,0.381,638,0.555,44,0.596,4.7,552,276,270,0.5,1066,0.518,53,0.545,4.8,2017-18
122,1627884,Derrick Jones Jr.,1610612748,MIA,20,9,11,245.0,21,12,9,0.571,34,0.618,1,0.636,8.0,17,0,17,0.0,33,0.515,2,0.548,7.4,38,12,26,0.316,67,0.567,3,0.594,7.7,2017-18
123,201565,Derrick Rose,1610612750,MIN,25,15,10,419.0,13,5,6,0.385,35,0.371,0,0.371,13.0,22,6,16,0.273,42,0.524,6,0.611,9.7,35,11,22,0.314,77,0.455,6,0.493,10.8,2017-18
124,1628476,Derrick Walton Jr.,1610612748,MIA,16,8,8,147.0,2,0,2,0.0,5,0.4,0,0.4,19.6,14,3,11,0.214,29,0.483,5,0.583,8.5,16,3,13,0.188,34,0.471,5,0.552,9.9,2017-18
125,1628401,Derrick White,1610612759,SAS,17,7,10,139.0,5,2,3,0.4,13,0.385,0,0.385,12.5,21,8,13,0.381,33,0.636,1,0.656,4.9,26,10,16,0.385,45,0.578,1,0.591,6.3,2017-18
126,202682,Derrick Williams,1610612747,LAL,2,1,1,9.0,0,0,0,0.0,3,0.0,0,0.0,0.0,1,0,1,0.0,1,1.0,0,1.0,3.5,1,0,1,0.0,3,0.333,0,0.333,3.5,2017-18
127,1626164,Devin Booker,1610612756,PHX,54,16,38,1865.0,26,10,17,0.385,157,0.166,6,0.172,12.1,218,24,193,0.11,373,0.584,31,0.637,7.8,244,34,210,0.139,523,0.467,37,0.502,8.4,2017-18
128,2734,Devin Harris,1610612743,DEN,71,33,38,1340.0,12,3,9,0.25,69,0.174,4,0.185,17.3,115,26,90,0.226,207,0.556,19,0.612,8.5,127,29,99,0.228,269,0.472,23,0.516,9.3,2017-18
129,1628421,Devin Robinson,1610612764,WAS,1,0,1,13.0,2,1,0,0.5,4,0.5,0,0.5,2.2,3,1,2,0.333,4,0.75,0,0.75,5.6,5,2,2,0.4,8,0.625,0,0.625,4.7,2017-18
130,203473,Dewayne Dedmon,1610612737,ATL,61,18,43,1520.0,100,62,37,0.62,267,0.375,4,0.38,6.3,381,119,258,0.312,586,0.65,23,0.677,4.4,481,181,295,0.376,817,0.589,27,0.609,4.8,2017-18
131,1627738,Deyonta Davis,1610612763,MEM,62,16,46,943.0,75,41,29,0.547,163,0.46,3,0.469,5.9,175,57,117,0.326,309,0.566,24,0.614,4.8,250,98,146,0.392,454,0.551,27,0.585,5.1,2017-18
132,1628415,Dillon Brooks,1610612763,MEM,82,22,60,2350.0,49,21,27,0.429,183,0.268,2,0.271,9.0,208,47,162,0.226,377,0.552,27,0.594,6.9,257,68,189,0.265,545,0.472,29,0.498,7.3,2017-18
133,203079,Dion Waiters,1610612748,MIA,29,15,14,893.0,8,1,7,0.125,60,0.133,3,0.14,15.5,68,6,62,0.088,129,0.527,10,0.571,9.3,76,7,69,0.092,187,0.406,13,0.437,9.9,2017-18
134,1717,Dirk Nowitzki,1610612742,DAL,77,24,53,1900.0,22,14,6,0.636,79,0.278,3,0.289,9.7,416,144,271,0.346,677,0.614,50,0.663,4.3,438,158,277,0.361,726,0.603,53,0.651,4.5,2017-18
135,1627734,Domantas Sabonis,1610612754,IND,74,45,29,1810.0,165,118,47,0.715,446,0.37,11,0.379,6.1,407,136,267,0.334,690,0.59,44,0.63,4.1,572,254,314,0.444,1094,0.523,55,0.551,4.7,2017-18
136,1628378,Donovan Mitchell,1610612762,UTA,79,46,33,2638.0,52,23,30,0.442,251,0.207,11,0.217,11.8,244,44,199,0.18,460,0.53,29,0.566,8.4,296,67,229,0.226,697,0.425,40,0.451,9.0,2017-18
137,1627827,Dorian Finney-Smith,1610612742,DAL,21,4,17,448.0,22,11,11,0.5,55,0.4,0,0.4,8.0,53,14,39,0.264,98,0.541,14,0.631,4.8,75,25,50,0.333,147,0.51,14,0.564,5.7,2017-18
138,203926,Doug McDermott,1610612742,DAL,80,29,51,1736.0,40,25,15,0.625,133,0.301,3,0.308,6.1,159,40,119,0.252,288,0.552,29,0.614,6.5,199,65,134,0.327,412,0.483,32,0.524,6.5,2017-18
139,1627733,Dragan Bender,1610612756,PHX,82,21,61,2069.0,40,22,17,0.55,164,0.244,6,0.253,8.9,321,77,244,0.24,594,0.54,55,0.596,4.8,361,99,261,0.274,720,0.501,61,0.548,5.2,2017-18
140,203110,Draymond Green,1610612744,GSW,70,48,22,2287.0,75,52,20,0.693,215,0.349,6,0.359,6.4,460,131,325,0.285,798,0.576,44,0.61,5.0,535,183,345,0.342,969,0.552,50,0.582,5.2,2017-18
141,1628407,Dwayne Bacon,1610612766,CHA,53,25,28,713.0,4,1,3,0.25,38,0.105,1,0.108,12.5,120,27,93,0.225,179,0.67,11,0.714,6.0,124,28,96,0.226,207,0.599,12,0.636,6.2,2017-18
142,202779,Dwight Buycks,1610612765,DET,29,10,19,427.0,12,3,9,0.25,48,0.25,2,0.261,12.0,29,3,26,0.103,76,0.382,9,0.433,8.2,41,6,35,0.146,124,0.331,11,0.363,9.3,2017-18
143,2730,Dwight Howard,1610612766,CHA,81,35,46,2463.0,255,173,73,0.678,620,0.411,11,0.419,4.1,757,237,516,0.313,1118,0.677,68,0.721,3.8,1012,410,589,0.405,1694,0.597,79,0.627,3.9,2017-18
144,203939,Dwight Powell,1610612742,DAL,79,23,56,1672.0,135,80,55,0.593,386,0.35,6,0.355,6.6,309,83,225,0.269,522,0.592,48,0.652,5.3,444,163,280,0.367,872,0.509,54,0.543,5.7,2017-18
145,2548,Dwyane Wade,1610612748,MIA,67,37,30,1536.0,50,29,21,0.58,173,0.289,6,0.299,8.3,202,45,158,0.223,367,0.55,37,0.612,6.5,252,74,179,0.294,530,0.475,43,0.517,6.9,2017-18
146,202734,E'Twaun Moore,1610612740,NOP,82,48,34,2586.0,57,23,35,0.404,165,0.345,4,0.354,10.7,181,36,143,0.199,361,0.501,35,0.555,9.5,238,59,178,0.248,515,0.462,39,0.5,9.8,2017-18
147,202334,Ed Davis,1610612757,POR,78,48,30,1471.0,183,122,58,0.667,476,0.384,11,0.394,5.3,392,122,265,0.311,653,0.6,54,0.654,4.0,575,244,323,0.424,1103,0.521,65,0.554,4.4,2017-18
148,1628410,Edmond Sumner,1610612754,IND,1,0,1,2.0,0,0,0,0.0,0,0.0,0,0.0,0.0,1,0,1,0.0,1,1.0,0,1.0,6.5,1,0,1,0.0,1,1.0,0,1.0,6.5,2017-18
149,202327,Ekpe Udoh,1610612762,UTA,63,36,27,810.0,68,39,29,0.574,155,0.439,3,0.447,7.5,82,29,54,0.354,198,0.414,24,0.471,5.4,150,68,83,0.453,343,0.437,27,0.475,6.4,2017-18
150,203901,Elfrid Payton,1610612756,PHX,63,13,50,1808.0,64,30,33,0.469,239,0.268,7,0.276,10.9,210,26,181,0.124,338,0.621,17,0.654,8.0,274,56,214,0.204,570,0.481,24,0.502,8.7,2017-18
151,2731,Emeka Okafor,1610612740,NOP,26,16,10,353.0,47,23,23,0.489,83,0.566,0,0.566,5.7,73,25,47,0.342,159,0.459,17,0.514,5.3,120,48,70,0.4,239,0.502,17,0.541,5.5,2017-18
152,1626144,Emmanuel Mudiay,1610612752,NYK,64,29,35,1244.0,26,13,13,0.5,125,0.208,6,0.218,10.2,126,20,104,0.159,210,0.6,12,0.636,8.0,152,33,117,0.217,330,0.461,18,0.487,8.4,2017-18
153,202683,Enes Kanter,1610612752,NYK,70,26,44,1807.0,271,204,56,0.753,637,0.425,12,0.434,4.6,504,144,360,0.286,824,0.612,66,0.665,4.0,775,348,416,0.449,1432,0.541,78,0.572,4.2,2017-18
154,202339,Eric Bledsoe,1610612749,MIL,74,40,34,2322.0,51,23,29,0.451,203,0.251,5,0.258,8.6,233,43,187,0.185,447,0.521,37,0.568,9.0,284,66,216,0.232,633,0.449,42,0.481,8.9,2017-18
155,201569,Eric Gordon,1610612745,HOU,69,55,14,2154.0,25,9,18,0.36,117,0.214,9,0.231,14.7,145,17,126,0.117,253,0.573,14,0.607,9.0,170,26,144,0.153,362,0.47,23,0.501,10.0,2017-18
156,203961,Eric Moreland,1610612765,DET,67,32,35,805.0,81,52,29,0.642,240,0.338,5,0.345,4.4,197,59,137,0.299,338,0.583,21,0.621,4.1,278,111,166,0.399,560,0.496,26,0.521,4.2,2017-18
157,1628571,Erik McCree,1610612762,UTA,4,4,0,8.0,0,0,0,0.0,0,0.0,0,0.0,0.0,1,0,1,0.0,1,1.0,0,1.0,0.8,1,0,1,0.0,1,1.0,0,1.0,0.8,2017-18
158,101141,Ersan Ilyasova,1610612755,PHI,69,36,33,1730.0,118,76,41,0.644,286,0.413,8,0.424,6.4,287,86,199,0.3,488,0.588,28,0.624,5.4,405,162,240,0.4,743,0.545,36,0.573,5.7,2017-18
159,203095,Evan Fournier,1610612753,ORL,57,20,37,1837.0,23,10,14,0.435,126,0.183,2,0.185,12.6,157,27,128,0.172,300,0.523,28,0.577,8.1,180,37,142,0.206,416,0.433,30,0.466,8.7,2017-18
160,202323,Evan Turner,1610612757,POR,79,48,31,2034.0,30,12,17,0.4,152,0.197,4,0.203,10.6,214,59,156,0.276,400,0.535,47,0.606,5.7,244,71,173,0.291,537,0.454,51,0.502,6.3,2017-18
161,1626163,Frank Kaminsky,1610612766,CHA,79,35,44,1835.0,46,22,24,0.478,160,0.288,8,0.303,9.7,242,44,198,0.182,426,0.568,36,0.621,6.1,288,66,222,0.229,562,0.512,44,0.556,6.6,2017-18
162,1628412,Frank Mason,1610612758,SAC,52,17,35,984.0,30,11,19,0.367,89,0.337,4,0.353,12.0,100,14,83,0.14,156,0.641,8,0.676,8.3,130,25,102,0.192,243,0.535,12,0.563,9.2,2017-18
163,1628373,Frank Ntilikina,1610612752,NYK,77,27,50,1693.0,37,12,26,0.324,101,0.366,3,0.378,13.3,139,30,108,0.216,262,0.531,22,0.579,9.4,176,42,134,0.239,359,0.49,25,0.527,10.3,2017-18
164,1627832,Fred VanVleet,1610612761,TOR,76,55,21,1520.0,25,7,17,0.28,133,0.188,4,0.194,17.9,159,25,134,0.157,326,0.488,23,0.525,8.8,184,32,151,0.174,456,0.404,27,0.429,10.0,2017-18
165,1627788,Furkan Korkmaz,1610612755,PHI,14,11,3,80.0,2,0,2,0.0,3,0.667,0,0.667,7.7,9,0,9,0.0,11,0.818,0,0.818,8.5,11,0,11,0.0,13,0.846,0,0.846,8.4,2017-18
166,202066,Garrett Temple,1610612758,SAC,65,23,42,1615.0,22,12,10,0.545,90,0.244,3,0.253,8.4,130,19,107,0.146,239,0.544,20,0.594,8.3,152,31,117,0.204,315,0.483,23,0.521,8.3,2017-18
167,203914,Gary Harris,1610612743,DEN,67,37,30,2305.0,37,16,20,0.432,130,0.285,1,0.287,10.3,139,19,116,0.137,229,0.607,16,0.653,9.3,176,35,136,0.199,357,0.493,17,0.518,9.5,2017-18
168,1627780,Gary Payton II,1610612747,LAL,23,10,13,221.0,13,8,6,0.615,37,0.351,1,0.361,5.4,31,6,25,0.194,54,0.574,3,0.608,4.5,44,14,31,0.318,88,0.5,4,0.524,4.8,2017-18
169,201588,George Hill,1610612739,CLE,67,28,39,1812.0,42,15,26,0.357,113,0.372,5,0.389,14.2,139,26,112,0.187,263,0.529,21,0.574,8.7,181,41,138,0.227,373,0.485,26,0.522,10.0,2017-18
170,1627777,Georges Niang,1610612762,UTA,9,9,0,32.0,3,0,3,0.0,4,0.75,0,0.75,16.6,6,0,5,0.0,7,0.857,0,0.857,7.6,9,0,8,0.0,10,0.9,0,0.9,10.9,2017-18
171,1627834,Georgios Papagiannis,1610612757,POR,17,3,14,122.0,13,10,1,0.769,27,0.481,0,0.481,4.5,24,9,15,0.375,41,0.585,0,0.585,3.8,37,19,16,0.514,62,0.597,0,0.597,4.0,2017-18
172,101123,Gerald Green,1610612745,HOU,41,33,8,929.0,15,4,11,0.267,65,0.231,2,0.238,14.3,118,14,104,0.119,205,0.576,10,0.605,6.6,133,18,115,0.135,263,0.506,12,0.53,7.5,2017-18
173,1628492,Gian Clavell,1610612742,DAL,7,0,7,64.0,1,0,1,0.0,1,1.0,0,1.0,18.7,6,1,5,0.167,8,0.75,1,0.857,6.6,7,1,6,0.143,9,0.778,1,0.875,8.3,2017-18
174,203507,Giannis Antetokounmpo,1610612749,MIL,74,39,35,2715.0,156,97,55,0.622,439,0.355,8,0.362,6.7,587,144,435,0.245,909,0.646,49,0.683,5.7,743,241,490,0.324,1273,0.584,57,0.611,5.9,2017-18
175,203922,Glenn Robinson III,1610612754,IND,23,14,9,338.0,11,5,7,0.455,29,0.379,1,0.393,8.9,26,5,21,0.192,44,0.591,3,0.634,7.4,37,10,28,0.27,72,0.514,4,0.544,8.0,2017-18
176,201609,Goran Dragic,1610612748,MIA,74,38,36,2349.0,54,27,26,0.5,209,0.258,9,0.27,11.1,245,33,212,0.135,480,0.51,42,0.559,9.1,299,60,238,0.201,677,0.442,51,0.478,9.4,2017-18
177,202330,Gordon Hayward,1610612738,BOS,1,0,1,5.0,0,0,0,0.0,2,0.0,0,0.0,0.0,1,0,1,0.0,2,0.5,0,0.5,21.8,1,0,1,0.0,4,0.25,0,0.25,21.8,2017-18
178,203476,Gorgui Dieng,1610612750,MIN,79,45,34,1333.0,106,59,47,0.557,211,0.502,2,0.507,7.7,254,79,174,0.311,434,0.585,23,0.618,5.3,360,138,221,0.383,620,0.581,25,0.605,6.0,2017-18
179,202328,Greg Monroe,1610612738,BOS,50,21,29,1024.0,109,77,32,0.706,267,0.408,7,0.419,4.9,235,85,150,0.362,356,0.66,24,0.708,3.9,344,162,182,0.471,598,0.575,31,0.607,4.2,2017-18
180,1627824,Guerschon Yabusele,1610612738,BOS,32,23,9,233.0,17,8,8,0.471,46,0.37,3,0.395,8.7,35,8,27,0.229,66,0.53,9,0.614,6.0,52,16,35,0.308,104,0.5,12,0.565,6.8,2017-18
181,203084,Harrison Barnes,1610612742,DAL,77,24,53,2634.0,77,39,36,0.506,261,0.295,8,0.304,8.5,391,74,315,0.189,659,0.593,57,0.65,6.1,468,113,351,0.241,879,0.532,65,0.575,6.5,2017-18
182,202355,Hassan Whiteside,1610612748,MIA,54,30,24,1364.0,174,118,55,0.678,407,0.428,7,0.435,4.8,444,164,279,0.369,669,0.664,41,0.707,3.5,618,282,334,0.456,1051,0.588,48,0.616,3.8,2017-18
183,1627740,Henry Ellenson,1610612765,DET,38,21,17,329.0,10,6,4,0.6,31,0.323,0,0.323,6.6,71,18,51,0.254,121,0.587,9,0.634,5.4,81,24,55,0.296,148,0.547,9,0.583,5.5,2017-18
184,203546,Ian Clark,1610612740,NOP,74,43,31,1454.0,10,1,9,0.1,58,0.172,5,0.189,13.1,117,13,101,0.111,198,0.591,20,0.657,9.2,127,14,110,0.11,253,0.502,25,0.557,9.5,2017-18
185,101133,Ian Mahinmi,1610612764,WAS,77,42,35,1145.0,135,82,53,0.607,306,0.441,10,0.456,5.5,177,55,122,0.311,356,0.497,39,0.558,5.3,312,137,175,0.439,639,0.488,49,0.529,5.4,2017-18
186,1628387,Ike Anigbogu,1610612754,IND,11,5,6,30.0,5,4,1,0.8,9,0.556,0,0.556,4.7,4,1,3,0.25,14,0.286,2,0.333,9.3,9,5,4,0.556,21,0.429,2,0.474,6.8,2017-18
187,202697,Iman Shumpert,1610612758,SAC,14,9,5,276.0,7,0,6,0.0,22,0.318,0,0.318,19.7,34,6,29,0.176,52,0.654,3,0.694,6.7,41,6,35,0.146,72,0.569,3,0.594,8.6,2017-18
188,203477,Isaiah Canaan,1610612760,OKC,20,9,11,422.0,6,4,2,0.667,34,0.176,2,0.188,7.7,39,5,34,0.128,75,0.52,4,0.549,7.3,45,9,36,0.2,107,0.421,6,0.446,7.4,2017-18
189,1628439,Isaiah Hicks,1610612752,NYK,18,4,14,239.0,10,6,4,0.6,34,0.294,1,0.303,7.0,31,9,22,0.29,68,0.456,6,0.5,5.9,41,15,26,0.366,99,0.414,7,0.446,6.2,2017-18
190,1627819,Isaiah Taylor,1610612737,ATL,67,18,49,1167.0,22,4,18,0.182,85,0.259,5,0.275,15.3,72,13,60,0.181,131,0.55,12,0.605,9.5,94,17,78,0.181,212,0.443,17,0.482,10.9,2017-18
191,202738,Isaiah Thomas,1610612747,LAL,32,15,17,862.0,17,6,11,0.353,61,0.279,3,0.293,14.9,50,9,39,0.18,102,0.49,9,0.538,10.9,67,15,50,0.224,163,0.411,12,0.444,11.9,2017-18
192,1627785,Isaiah Whitehead,1610612751,BKN,15,2,13,163.0,3,3,0,1.0,11,0.273,0,0.273,4.1,18,5,13,0.278,27,0.667,2,0.72,8.0,21,8,13,0.381,38,0.553,2,0.583,7.4,2017-18
193,202397,Ish Smith,1610612765,DET,82,39,43,2043.0,27,6,21,0.222,159,0.17,1,0.171,11.2,197,33,161,0.168,406,0.485,45,0.546,8.6,224,39,182,0.174,561,0.399,46,0.435,8.9,2017-18
194,1628397,Ivan Rabb,1610612763,MEM,36,6,30,516.0,53,44,8,0.83,132,0.402,4,0.414,5.8,105,39,67,0.371,177,0.593,10,0.629,5.2,158,83,75,0.525,293,0.539,14,0.566,5.4,2017-18
195,1627826,Ivica Zubac,1610612747,LAL,43,19,24,410.0,45,30,13,0.667,93,0.484,3,0.5,4.1,78,30,44,0.385,140,0.557,12,0.609,4.0,123,60,57,0.488,231,0.532,15,0.569,4.0,2017-18
196,200826,J.J. Barea,1610612742,DAL,69,23,46,1603.0,15,4,13,0.267,112,0.134,6,0.142,16.6,186,17,167,0.091,320,0.581,25,0.631,8.4,201,21,180,0.104,427,0.471,31,0.508,9.1,2017-18
197,200755,JJ Redick,1610612755,PHI,69,45,24,2086.0,9,1,8,0.111,73,0.123,3,0.129,25.7,162,17,145,0.105,291,0.557,22,0.602,10.0,171,18,153,0.105,356,0.48,25,0.517,10.8,2017-18
198,2747,JR Smith,1610612739,CLE,80,49,31,2244.0,29,14,15,0.483,101,0.287,5,0.302,13.8,206,33,171,0.16,347,0.594,28,0.646,8.5,235,47,186,0.2,430,0.547,33,0.592,9.1,2017-18
199,203960,JaKarr Sampson,1610612758,SAC,22,6,16,344.0,21,12,8,0.571,55,0.382,2,0.396,5.6,57,7,50,0.123,102,0.559,9,0.613,4.5,78,19,58,0.244,153,0.51,11,0.549,4.8,2017-18
200,203210,JaMychal Green,1610612763,MEM,55,11,44,1542.0,147,104,41,0.707,396,0.371,4,0.375,6.0,317,75,241,0.237,456,0.695,19,0.725,4.8,464,179,282,0.386,811,0.572,23,0.589,5.2,2017-18
201,201580,JaVale McGee,1610612744,GSW,65,45,20,615.0,59,40,18,0.678,133,0.444,4,0.457,6.1,110,48,60,0.436,200,0.55,14,0.591,5.1,169,88,78,0.521,323,0.523,18,0.554,5.5,2017-18
202,1628444,Jabari Bird,1610612738,BOS,13,8,5,115.0,6,2,4,0.333,13,0.462,2,0.545,5.5,13,1,11,0.077,19,0.684,1,0.722,7.7,19,3,15,0.158,32,0.594,3,0.655,7.0,2017-18
203,203953,Jabari Parker,1610612749,MIL,31,16,15,743.0,42,22,20,0.524,116,0.362,1,0.365,9.4,109,18,90,0.165,197,0.553,12,0.589,6.5,151,40,110,0.265,295,0.512,13,0.535,7.3,2017-18
204,204022,Jack Cooley,1610612758,SAC,7,4,3,87.0,14,10,3,0.714,42,0.333,0,0.333,3.3,16,4,12,0.25,28,0.571,1,0.593,6.3,30,14,15,0.467,68,0.441,1,0.448,5.0,2017-18
205,1626643,Jacob Pullen,1610612755,PHI,3,2,1,6.0,0,0,0,0.0,0,0.0,0,0.0,0.0,0,0,0,0.0,0,0.0,0,0.0,0.0,0,0,0,0.0,0,0.0,0,0.0,0.0,2017-18
206,1628451,Jacob Wiley,1610612751,BKN,4,1,3,32.0,2,1,1,0.5,5,0.4,0,0.4,4.0,9,0,9,0.0,13,0.692,1,0.75,3.3,11,1,10,0.091,17,0.647,1,0.688,3.4,2017-18
207,203109,Jae Crowder,1610612762,UTA,80,52,28,2090.0,59,29,31,0.492,178,0.331,9,0.349,9.6,216,42,173,0.194,380,0.568,25,0.608,6.6,275,71,204,0.258,540,0.509,34,0.543,7.3,2017-18
208,1626143,Jahlil Okafor,1610612751,BKN,28,7,21,353.0,21,15,6,0.714,69,0.304,2,0.313,4.8,64,24,39,0.375,105,0.61,8,0.66,4.5,85,39,45,0.459,165,0.515,10,0.548,4.6,2017-18
209,1627774,Jake Layman,1610612757,POR,35,22,13,160.0,4,3,1,0.75,12,0.333,1,0.364,5.7,12,2,10,0.167,19,0.632,3,0.75,6.6,16,5,11,0.313,28,0.571,4,0.667,6.4,2017-18
210,1627751,Jakob Poeltl,1610612761,TOR,82,59,23,1524.0,165,125,41,0.758,389,0.424,5,0.43,6.0,228,113,113,0.496,501,0.455,47,0.502,4.0,393,238,154,0.606,867,0.453,52,0.482,4.9,2017-18
211,1627883,Jalen Jones,1610612742,DAL,16,3,13,181.0,13,7,6,0.538,36,0.361,3,0.394,8.9,25,3,22,0.12,38,0.658,2,0.694,5.6,38,10,28,0.263,68,0.559,5,0.603,6.7,2017-18
212,2037,Jamal Crawford,1610612750,MIN,80,45,35,1653.0,21,5,15,0.238,51,0.412,3,0.438,17.9,78,3,74,0.038,134,0.582,8,0.619,11.6,99,8,89,0.081,183,0.541,11,0.576,12.9,2017-18
213,1627750,Jamal Murray,1610612743,DEN,81,46,35,2565.0,82,36,47,0.439,258,0.318,9,0.329,10.4,215,37,174,0.172,415,0.518,33,0.563,7.8,297,73,221,0.246,665,0.447,42,0.477,8.6,2017-18
214,1627866,Jameel Warney,1610612742,DAL,3,1,2,27.0,4,4,0,1.0,13,0.308,0,0.308,2.6,5,1,4,0.2,6,0.833,0,0.833,5.1,9,5,4,0.556,19,0.474,0,0.474,4.0,2017-18
215,2749,Jameer Nelson,1610612765,DET,50,25,25,1013.0,13,3,9,0.231,55,0.236,1,0.241,16.7,91,11,80,0.121,152,0.599,17,0.674,8.2,104,14,89,0.135,203,0.512,18,0.562,9.2,2017-18
216,1628503,Jamel Artis,1610612753,ORL,15,4,11,279.0,4,2,2,0.5,20,0.2,1,0.211,8.6,34,9,23,0.265,58,0.586,5,0.642,6.9,38,11,25,0.289,76,0.5,6,0.543,7.1,2017-18
217,203516,James Ennis III,1610612765,DET,72,25,47,1604.0,73,37,37,0.507,201,0.363,5,0.372,10.9,151,36,114,0.238,279,0.541,19,0.581,5.5,224,73,151,0.326,464,0.483,24,0.509,7.3,2017-18
218,201935,James Harden,1610612745,HOU,72,59,13,2551.0,41,20,21,0.488,255,0.161,9,0.167,9.0,348,47,300,0.135,566,0.615,38,0.659,7.4,389,67,321,0.172,783,0.497,47,0.529,7.6,2017-18
219,201949,James Johnson,1610612748,MIA,72,36,36,1912.0,60,24,35,0.4,207,0.29,6,0.299,11.5,291,61,228,0.21,516,0.564,30,0.599,5.4,351,85,263,0.242,685,0.512,36,0.541,6.4,2017-18
220,203949,James Michael McAdoo,1610612755,PHI,3,1,2,18.0,0,0,0,0.0,1,0.0,0,0.0,0.0,2,1,1,0.5,2,1.0,0,1.0,6.8,2,1,1,0.5,3,0.667,0,0.667,6.8,2017-18
221,1627821,James Webb III,1610612751,BKN,10,1,9,120.0,8,4,4,0.5,16,0.5,2,0.571,7.8,16,1,15,0.063,25,0.64,5,0.8,5.0,24,5,19,0.208,40,0.6,7,0.727,5.9,2017-18
222,203923,James Young,1610612755,PHI,6,4,2,61.0,0,0,0,0.0,1,0.0,0,0.0,0.0,2,0,2,0.0,4,0.5,0,0.5,9.4,2,0,2,0.0,5,0.4,0,0.4,9.4,2017-18
223,203966,Jamil Wilson,1610612746,LAC,15,6,9,274.0,3,2,1,0.667,15,0.2,0,0.2,15.4,29,7,21,0.241,68,0.426,5,0.46,6.4,32,9,22,0.281,81,0.395,5,0.421,7.3,2017-18
224,201162,Jared Dudley,1610612756,PHX,48,7,41,686.0,8,5,3,0.625,42,0.19,3,0.205,7.5,86,16,68,0.186,181,0.475,14,0.515,7.1,94,21,71,0.223,216,0.435,17,0.472,7.1,2017-18
225,204067,Jarell Eddie,1610612741,CHI,3,1,2,9.0,0,0,0,0.0,0,0.0,0,0.0,0.0,1,1,0,1.0,1,1.0,0,1.0,2.8,1,1,0,1.0,1,1.0,0,1.0,2.8,2017-18
226,1626185,Jarell Martin,1610612763,MEM,73,21,52,1661.0,97,66,31,0.68,309,0.314,7,0.321,7.1,221,53,167,0.24,443,0.499,35,0.542,5.0,318,119,198,0.374,722,0.44,42,0.468,5.6,2017-18
227,1628386,Jarrett Allen,1610612751,BKN,70,24,46,1401.0,142,98,42,0.69,341,0.416,8,0.426,5.7,236,63,173,0.267,459,0.514,36,0.558,4.9,378,161,215,0.426,765,0.494,44,0.524,5.2,2017-18
228,101127,Jarrett Jack,1610612752,NYK,61,25,36,1513.0,20,2,19,0.1,65,0.308,1,0.313,15.7,163,11,152,0.067,260,0.627,14,0.663,9.9,183,13,171,0.071,322,0.568,15,0.596,10.6,2017-18
229,201160,Jason Smith,1610612764,WAS,33,15,18,285.0,18,8,9,0.444,43,0.419,0,0.419,8.1,35,14,21,0.4,65,0.538,5,0.583,4.9,53,22,30,0.415,100,0.53,5,0.558,6.0,2017-18
230,1891,Jason Terry,1610612749,MIL,51,27,24,814.0,5,0,5,0.0,20,0.25,1,0.263,19.4,43,6,37,0.14,70,0.614,5,0.662,11.0,48,6,42,0.125,90,0.533,6,0.571,11.8,2017-18
231,1628393,Jawun Evans,1610612746,LAC,48,24,24,778.0,9,3,8,0.333,54,0.167,2,0.173,13.2,75,18,57,0.24,155,0.484,19,0.551,7.4,84,21,65,0.25,205,0.41,21,0.457,8.2,2017-18
232,1627759,Jaylen Brown,1610612738,BOS,67,44,23,2050.0,60,32,31,0.533,233,0.258,6,0.264,9.0,269,60,208,0.223,435,0.618,27,0.659,6.2,329,92,239,0.28,648,0.508,33,0.535,6.7,2017-18
233,1628537,Jaylen Morris,1610612737,ATL,6,2,4,98.0,2,0,3,0.0,14,0.143,0,0.143,4.2,14,2,11,0.143,25,0.56,1,0.583,8.8,16,2,14,0.125,38,0.421,1,0.432,8.6,2017-18
234,1628369,Jayson Tatum,1610612738,BOS,77,50,27,2362.0,49,26,22,0.531,196,0.25,6,0.258,9.5,340,63,277,0.185,546,0.623,29,0.658,6.5,389,89,299,0.229,725,0.537,35,0.564,6.9,2017-18
235,201145,Jeff Green,1610612739,CLE,78,47,31,1828.0,60,38,22,0.633,165,0.364,5,0.375,8.4,186,67,119,0.36,351,0.53,19,0.56,6.4,246,105,141,0.427,504,0.488,24,0.513,6.9,2017-18
236,201952,Jeff Teague,1610612750,MIN,70,41,29,2311.0,24,3,21,0.125,135,0.178,3,0.182,16.1,185,17,167,0.092,349,0.53,26,0.573,9.7,209,20,188,0.096,480,0.435,29,0.463,10.4,2017-18
237,203481,Jeff Withey,1610612742,DAL,10,2,8,39.0,1,1,0,1.0,5,0.2,0,0.2,2.5,9,3,6,0.333,16,0.563,1,0.6,4.4,10,4,6,0.4,19,0.526,1,0.556,4.2,2017-18
238,203924,Jerami Grant,1610612760,OKC,80,48,32,1625.0,84,50,31,0.595,240,0.35,8,0.362,7.5,231,74,157,0.32,414,0.558,25,0.594,5.9,315,124,188,0.394,632,0.498,33,0.526,6.3,2017-18
239,202379,Jeremy Evans,1610612737,ATL,1,0,1,5.0,1,0,1,0.0,1,1.0,0,1.0,5.6,0,0,0,0.0,0,0.0,0,0.0,0.0,1,0,1,0.0,1,1.0,0,1.0,5.6,2017-18
240,203087,Jeremy Lamb,1610612766,CHA,80,36,44,1967.0,49,24,25,0.49,159,0.308,6,0.32,12.3,275,46,229,0.167,448,0.614,36,0.667,5.8,324,70,254,0.216,601,0.539,42,0.58,6.9,2017-18
241,202391,Jeremy Lin,1610612751,BKN,1,0,1,25.0,0,0,0,0.0,0,0.0,0,0.0,0.0,0,0,0,0.0,0,0.0,1,0.0,0.0,0,0,0,0.0,0,0.0,1,0.0,0.0,2017-18
242,1626170,Jerian Grant,1610612741,CHI,74,24,50,1686.0,31,11,20,0.355,134,0.231,3,0.237,14.7,140,17,126,0.121,276,0.507,27,0.562,7.5,171,28,146,0.164,403,0.424,30,0.458,8.8,2017-18
243,201573,Jerryd Bayless,1610612755,PHI,38,21,17,908.0,15,3,12,0.2,69,0.217,6,0.238,17.7,64,6,59,0.094,121,0.529,11,0.582,12.1,79,9,71,0.114,182,0.434,17,0.479,13.1,2017-18
244,202710,Jimmy Butler,1610612750,MIN,59,37,22,2164.0,79,34,45,0.43,236,0.335,12,0.353,10.1,235,59,173,0.251,401,0.586,38,0.647,7.7,314,93,218,0.296,629,0.499,50,0.542,8.3,2017-18
245,201149,Joakim Noah,1610612752,NYK,7,1,6,40.0,6,4,2,0.667,10,0.6,0,0.6,3.8,8,3,5,0.375,15,0.533,2,0.615,2.8,14,7,7,0.5,25,0.56,2,0.609,3.3,2017-18
246,201975,Jodie Meeks,1610612764,WAS,77,41,36,1119.0,15,6,10,0.4,41,0.366,1,0.375,15.2,111,13,95,0.117,174,0.638,20,0.721,8.9,126,19,105,0.151,213,0.592,21,0.656,9.8,2017-18
247,203925,Joe Harris,1610612751,BKN,77,26,51,1948.0,50,26,26,0.52,193,0.259,7,0.269,11.8,205,44,161,0.215,390,0.526,31,0.571,7.4,255,70,187,0.275,580,0.44,38,0.47,8.3,2017-18
248,204060,Joe Ingles,1610612762,UTA,82,48,34,2578.0,24,7,19,0.292,95,0.253,1,0.255,12.2,320,41,277,0.128,489,0.654,27,0.693,8.2,344,48,296,0.14,573,0.6,28,0.631,8.6,2017-18
249,2207,Joe Johnson,1610612745,HOU,55,35,20,1205.0,14,9,5,0.643,54,0.259,0,0.259,10.0,158,26,130,0.165,271,0.583,17,0.622,6.4,172,35,135,0.203,303,0.568,17,0.601,6.7,2017-18
250,1626202,Joe Young,1610612754,IND,53,28,25,558.0,12,2,10,0.167,41,0.293,3,0.316,15.0,51,4,48,0.078,78,0.654,6,0.708,11.0,63,6,58,0.095,114,0.553,9,0.6,11.7,2017-18
251,1627762,Joel Bolomboy,1610612762,UTA,6,3,3,38.0,6,4,2,0.667,9,0.667,0,0.667,6.5,4,0,4,0.0,6,0.667,1,0.8,4.5,10,4,6,0.4,14,0.714,1,0.769,5.7,2017-18
252,203954,Joel Embiid,1610612755,PHI,62,41,21,1882.0,143,100,42,0.699,392,0.365,9,0.373,6.3,537,198,339,0.369,874,0.614,57,0.657,3.7,680,298,381,0.438,1215,0.56,66,0.592,4.3,2017-18
253,203530,Joffrey Lauvergne,1610612759,SAS,55,30,25,534.0,63,42,22,0.667,165,0.382,3,0.389,5.3,108,28,79,0.259,167,0.647,11,0.692,4.1,171,70,101,0.409,318,0.538,14,0.563,4.5,2017-18
254,1628381,John Collins,1610612737,ATL,73,21,52,1760.0,173,115,56,0.665,508,0.341,8,0.346,6.1,361,124,239,0.343,697,0.518,63,0.569,4.0,534,239,295,0.448,1160,0.46,71,0.49,4.7,2017-18
255,203089,John Henson,1610612749,MIL,75,39,36,1953.0,150,107,41,0.713,351,0.427,6,0.435,4.9,360,137,223,0.381,633,0.569,32,0.599,4.3,510,244,264,0.478,945,0.54,38,0.562,4.5,2017-18
256,204066,John Holland,1610612739,CLE,24,17,7,174.0,6,3,3,0.5,12,0.5,0,0.5,14.0,18,4,14,0.222,36,0.5,2,0.529,8.2,24,7,17,0.292,45,0.533,2,0.558,9.7,2017-18
257,202322,John Wall,1610612764,WAS,41,23,18,1410.0,22,1,20,0.045,126,0.175,9,0.188,22.8,128,9,117,0.07,243,0.527,20,0.574,9.3,150,10,137,0.067,366,0.41,29,0.445,11.3,2017-18
258,1628405,Johnathan Motley,1610612742,DAL,11,1,10,176.0,14,10,4,0.714,39,0.359,1,0.368,6.8,35,7,28,0.2,59,0.593,3,0.625,5.0,49,17,32,0.347,93,0.527,4,0.551,5.5,2017-18
259,203948,Johnny O'Bryant III,1610612766,CHA,36,15,21,379.0,29,22,8,0.759,83,0.349,1,0.354,4.9,64,15,49,0.234,126,0.508,12,0.561,5.1,93,37,57,0.398,204,0.456,13,0.487,5.0,2017-18
260,202720,Jon Leuer,1610612765,DET,8,5,3,136.0,7,4,3,0.571,16,0.438,0,0.438,6.6,25,8,17,0.32,59,0.424,5,0.463,4.3,32,12,20,0.375,74,0.432,5,0.464,4.8,2017-18
261,201973,Jonas Jerebko,1610612762,UTA,74,45,29,1133.0,53,24,28,0.453,148,0.358,5,0.371,8.9,193,36,156,0.187,355,0.544,24,0.583,4.9,246,60,184,0.244,482,0.51,29,0.543,5.8,2017-18
262,202685,Jonas Valanciunas,1610612761,TOR,77,56,21,1727.0,183,134,46,0.732,474,0.386,9,0.394,5.2,477,161,312,0.338,796,0.599,53,0.642,3.5,660,295,358,0.447,1227,0.538,62,0.567,3.9,2017-18
263,1626780,Jonathan Gibson,1610612738,BOS,4,2,2,40.0,0,0,0,0.0,0,0.0,0,0.0,0.0,3,1,2,0.333,7,0.429,0,0.429,8.8,3,1,2,0.333,7,0.429,0,0.429,8.8,2017-18
264,1628371,Jonathan Isaac,1610612753,ORL,27,11,16,535.0,16,11,5,0.688,57,0.281,1,0.286,5.4,83,30,52,0.361,164,0.506,12,0.546,4.3,99,41,57,0.414,213,0.465,13,0.495,4.5,2017-18
265,203613,Jonathon Simmons,1610612753,ORL,69,21,48,2029.0,61,37,27,0.607,186,0.328,10,0.347,9.8,178,29,142,0.163,317,0.562,18,0.595,8.2,239,66,169,0.276,499,0.479,28,0.507,8.6,2017-18
266,1628395,Jordan Bell,1610612744,GSW,57,43,14,809.0,60,35,25,0.583,150,0.4,3,0.408,7.2,147,44,98,0.299,260,0.565,21,0.615,5.2,207,79,123,0.382,392,0.528,24,0.563,5.8,2017-18
267,203903,Jordan Clarkson,1610612739,CLE,81,40,41,1887.0,57,26,32,0.456,175,0.326,7,0.339,9.1,160,24,136,0.15,310,0.516,23,0.557,8.3,217,50,168,0.23,475,0.457,30,0.488,8.6,2017-18
268,202348,Jordan Crawford,1610612740,NOP,5,3,2,53.0,2,1,1,0.5,2,1.0,0,1.0,17.8,2,1,1,0.5,6,0.333,1,0.4,9.3,4,2,2,0.5,8,0.5,1,0.571,13.5,2017-18
269,1626175,Jordan Mickey,1610612748,MIA,23,15,8,284.0,18,12,5,0.667,65,0.277,2,0.286,8.1,63,22,41,0.349,122,0.516,15,0.589,3.8,81,34,46,0.42,179,0.453,17,0.5,4.7,2017-18
270,101181,Jose Calderon,1610612739,CLE,57,33,24,914.0,14,6,8,0.429,40,0.35,1,0.359,13.2,70,6,64,0.086,129,0.543,17,0.625,8.8,84,12,72,0.143,168,0.5,18,0.56,9.6,2017-18
271,1627982,Josh Gray,1610612756,PHX,5,0,5,86.0,2,0,2,0.0,6,0.333,1,0.4,17.6,8,2,6,0.25,14,0.571,0,0.571,6.4,10,2,8,0.2,20,0.5,1,0.526,8.7,2017-18
272,1628404,Josh Hart,1610612747,LAL,63,27,36,1461.0,42,23,21,0.548,129,0.326,6,0.341,10.2,221,54,167,0.244,378,0.585,32,0.639,6.7,263,77,188,0.293,499,0.527,38,0.57,7.4,2017-18
273,203962,Josh Huestis,1610612760,OKC,68,43,25,968.0,41,15,26,0.366,98,0.418,2,0.427,9.4,119,29,91,0.244,236,0.504,19,0.548,6.2,160,44,117,0.275,324,0.494,21,0.528,7.0,2017-18
274,1628367,Josh Jackson,1610612756,PHX,77,19,58,1959.0,95,51,45,0.537,303,0.314,7,0.321,9.4,256,48,209,0.188,435,0.589,33,0.637,6.9,351,99,254,0.282,727,0.483,40,0.511,7.6,2017-18
275,203705,Josh Magette,1610612737,ATL,18,3,15,216.0,2,0,2,0.0,3,0.667,0,0.667,28.2,17,3,14,0.176,34,0.5,2,0.531,10.2,19,3,16,0.158,37,0.514,2,0.543,12.1,2017-18
276,201177,Josh McRoberts,1610612742,DAL,2,2,0,6.0,0,0,0,0.0,0,0.0,0,0.0,0.0,0,0,0,0.0,0,0.0,0,0.0,0.0,0,0,0,0.0,0,0.0,0,0.0,0.0,2017-18
277,1626196,Josh Richardson,1610612748,MIA,80,43,37,2657.0,68,29,37,0.426,233,0.292,9,0.304,11.6,211,28,183,0.133,421,0.501,31,0.541,9.0,279,57,220,0.204,639,0.437,40,0.466,9.6,2017-18
278,2746,Josh Smith,1610612740,NOP,3,2,1,12.0,3,0,3,0.0,4,0.75,1,1.0,2.7,1,1,0,1.0,2,0.5,0,0.5,2.0,4,1,3,0.25,6,0.667,1,0.8,2.5,2017-18
279,201950,Jrue Holiday,1610612740,NOP,81,47,34,2927.0,62,29,31,0.468,239,0.259,9,0.27,10.0,303,60,245,0.198,557,0.544,41,0.587,8.6,365,89,276,0.244,786,0.464,50,0.496,8.8,2017-18
280,1627823,Juancho Hernangomez,1610612743,DEN,25,15,10,277.0,18,12,4,0.667,34,0.529,0,0.529,7.9,36,12,22,0.333,65,0.554,7,0.621,4.5,54,24,26,0.444,97,0.557,7,0.6,5.6,2017-18
281,203944,Julius Randle,1610612747,LAL,82,35,47,2190.0,181,127,53,0.702,520,0.348,13,0.357,5.8,473,130,335,0.275,767,0.617,47,0.657,5.2,654,257,388,0.393,1223,0.535,60,0.562,5.4,2017-18
282,202933,Julyan Stone,1610612766,CHA,23,10,13,175.0,1,0,1,0.0,6,0.167,0,0.167,22.3,28,4,24,0.143,37,0.757,1,0.778,6.1,29,4,25,0.138,42,0.69,1,0.707,6.7,2017-18
283,1626147,Justin Anderson,1610612755,PHI,37,27,10,515.0,25,16,9,0.64,67,0.373,1,0.379,7.2,67,16,51,0.239,120,0.558,12,0.62,7.0,92,32,60,0.348,178,0.517,13,0.558,7.1,2017-18
284,203200,Justin Holiday,1610612741,CHI,72,24,48,2265.0,31,15,16,0.484,109,0.284,3,0.292,10.2,260,36,224,0.138,440,0.591,34,0.64,7.2,291,51,240,0.175,543,0.536,37,0.575,7.5,2017-18
285,1628382,Justin Jackson,1610612758,SAC,68,21,47,1506.0,27,12,15,0.444,101,0.267,3,0.276,8.7,160,27,131,0.169,244,0.656,10,0.684,7.3,187,39,146,0.209,331,0.565,13,0.588,7.5,2017-18
286,1628383,Justin Patton,1610612750,MIN,1,0,1,4.0,0,0,0,0.0,0,0.0,0,0.0,0.0,0,0,0,0.0,0,0.0,0,0.0,0.0,0,0,0,0.0,0,0.0,0,0.0,0.0,2017-18
287,1626159,Justise Winslow,1610612748,MIA,67,32,35,1655.0,63,36,27,0.571,244,0.258,5,0.264,8.7,301,97,202,0.322,546,0.551,51,0.608,5.4,364,133,229,0.365,770,0.473,56,0.51,6.0,2017-18
288,203994,Jusuf Nurkic,1610612757,POR,79,48,31,2088.0,189,144,41,0.762,530,0.357,7,0.361,5.4,519,187,329,0.36,910,0.57,74,0.621,3.9,708,331,370,0.468,1409,0.502,81,0.533,4.3,2017-18
289,1628443,Kadeem Allen,1610612738,BOS,18,9,9,107.0,4,2,2,0.5,11,0.364,0,0.364,4.6,7,1,6,0.143,15,0.467,1,0.5,7.8,11,3,8,0.273,26,0.423,1,0.44,6.6,2017-18
290,1626157,Karl-Anthony Towns,1610612750,MIN,82,47,35,2918.0,238,160,78,0.672,605,0.393,15,0.403,6.2,774,291,482,0.376,1224,0.632,70,0.671,4.4,1012,451,560,0.446,1751,0.578,85,0.607,4.8,2017-18
291,202695,Kawhi Leonard,1610612759,SAS,9,5,4,210.0,6,5,1,0.833,22,0.273,1,0.286,2.5,36,9,27,0.25,56,0.643,2,0.667,8.2,42,14,28,0.333,72,0.583,3,0.609,7.4,2017-18
292,1627770,Kay Felder,1610612765,DET,16,6,10,140.0,3,1,2,0.333,12,0.25,0,0.25,10.1,15,2,13,0.133,19,0.789,0,0.789,9.9,18,3,15,0.167,31,0.581,0,0.581,9.9,2017-18
293,203482,Kelly Olynyk,1610612748,MIA,75,41,34,1751.0,87,60,26,0.69,270,0.322,6,0.33,6.1,339,114,225,0.336,588,0.577,37,0.615,4.9,426,174,251,0.408,815,0.523,43,0.552,5.1,2017-18
294,1626162,Kelly Oubre Jr.,1610612764,WAS,81,43,38,2231.0,59,34,25,0.576,272,0.217,14,0.229,8.1,304,78,222,0.257,501,0.607,28,0.643,5.3,363,112,247,0.309,740,0.491,42,0.52,5.7,2017-18
295,202689,Kemba Walker,1610612766,CHA,80,36,44,2736.0,32,10,23,0.313,207,0.155,13,0.165,10.5,216,23,194,0.106,456,0.474,54,0.537,9.6,248,33,217,0.133,657,0.377,67,0.42,9.8,2017-18
296,2570,Kendrick Perkins,1610612739,CLE,1,0,1,15.0,0,0,0,0.0,2,0.0,0,0.0,0.0,1,0,1,0.0,3,0.333,1,0.5,3.7,1,0,1,0.0,5,0.2,1,0.25,3.7,2017-18
297,202702,Kenneth Faried,1610612743,DEN,32,16,16,461.0,68,49,18,0.721,163,0.417,1,0.42,4.8,85,31,56,0.365,139,0.612,5,0.634,5.1,153,80,74,0.523,291,0.526,6,0.537,4.9,2017-18
298,203145,Kent Bazemore,1610612737,ATL,64,19,45,1759.0,25,8,18,0.32,159,0.157,3,0.16,13.2,220,41,178,0.186,397,0.554,44,0.623,6.7,245,49,196,0.2,547,0.448,47,0.49,7.4,2017-18
299,203484,Kentavious Caldwell-Pope,1610612747,LAL,74,31,43,2458.0,60,31,29,0.517,176,0.341,4,0.349,8.1,327,53,265,0.162,537,0.609,41,0.659,7.1,387,84,294,0.217,705,0.549,45,0.586,7.3,2017-18
300,201142,Kevin Durant,1610612744,GSW,68,49,19,2325.0,31,15,19,0.484,155,0.2,7,0.209,11.9,433,117,312,0.27,675,0.641,38,0.68,6.2,464,132,331,0.284,793,0.585,45,0.62,6.6,2017-18
301,201567,Kevin Love,1610612739,CLE,59,37,22,1651.0,101,73,25,0.723,294,0.344,7,0.352,6.2,445,142,297,0.319,665,0.669,32,0.703,4.4,546,215,322,0.394,921,0.593,39,0.619,4.7,2017-18
302,1626172,Kevon Looney,1610612744,GSW,66,45,21,910.0,83,58,22,0.699,188,0.441,1,0.444,6.1,132,55,75,0.417,262,0.504,16,0.537,6.0,215,113,97,0.526,433,0.497,17,0.517,6.0,2017-18
303,203920,Khem Birch,1610612753,ORL,42,14,28,578.0,70,46,22,0.657,145,0.483,3,0.493,5.4,110,36,73,0.327,176,0.625,9,0.659,4.7,180,82,95,0.456,308,0.584,12,0.608,5.0,2017-18
304,203114,Khris Middleton,1610612749,MIL,81,44,37,2947.0,44,21,26,0.477,197,0.223,6,0.23,12.1,383,80,298,0.209,635,0.603,42,0.646,6.9,427,101,324,0.237,794,0.538,48,0.572,7.4,2017-18
305,202691,Klay Thompson,1610612744,GSW,73,55,18,2504.0,31,18,13,0.581,109,0.284,3,0.292,10.9,246,62,186,0.252,448,0.549,35,0.596,7.8,277,80,199,0.289,552,0.502,38,0.539,8.2,2017-18
306,1628424,Kobi Simmons,1610612763,MEM,32,6,26,643.0,14,7,7,0.5,50,0.28,1,0.286,11.4,36,2,34,0.056,62,0.581,5,0.632,9.1,50,9,41,0.18,111,0.45,6,0.476,9.8,2017-18
307,201585,Kosta Koufos,1610612758,SAC,71,22,49,1391.0,149,82,64,0.55,315,0.473,3,0.478,6.3,323,104,216,0.322,489,0.661,24,0.695,4.1,472,186,280,0.394,772,0.611,27,0.634,4.8,2017-18
308,1627739,Kris Dunn,1610612741,CHI,52,19,33,1525.0,24,5,20,0.208,136,0.176,4,0.182,13.7,197,31,165,0.157,372,0.53,46,0.604,6.8,221,36,185,0.163,503,0.439,50,0.488,7.6,2017-18
309,204001,Kristaps Porzingis,1610612752,NYK,48,22,26,1553.0,62,37,24,0.597,180,0.344,3,0.35,9.2,254,76,180,0.299,447,0.568,24,0.6,4.9,316,113,204,0.358,604,0.523,27,0.548,5.7,2017-18
310,203937,Kyle Anderson,1610612759,SAS,74,41,33,1978.0,84,55,27,0.655,223,0.377,8,0.391,6.5,312,64,247,0.205,457,0.683,27,0.726,6.3,396,119,274,0.301,650,0.609,35,0.644,6.3,2017-18
311,1627858,Kyle Collinsworth,1610612742,DAL,32,9,23,480.0,32,19,12,0.594,87,0.368,5,0.39,6.4,75,12,63,0.16,128,0.586,5,0.61,5.5,107,31,75,0.29,210,0.51,10,0.535,5.7,2017-18
312,2594,Kyle Korver,1610612739,CLE,73,43,30,1574.0,9,2,7,0.222,42,0.214,4,0.237,17.8,156,36,119,0.231,300,0.52,28,0.574,7.7,165,38,126,0.23,338,0.488,32,0.539,8.3,2017-18
313,1628398,Kyle Kuzma,1610612747,LAL,77,34,43,2401.0,88,54,32,0.614,283,0.311,8,0.32,8.2,395,94,295,0.238,672,0.588,54,0.639,5.2,483,148,327,0.306,912,0.53,62,0.568,5.8,2017-18
314,200768,Kyle Lowry,1610612761,TOR,78,57,21,2510.0,66,35,31,0.53,279,0.237,14,0.249,11.7,368,56,314,0.152,657,0.56,57,0.613,7.7,434,91,345,0.21,927,0.468,71,0.507,8.3,2017-18
315,203124,Kyle O'Quinn,1610612752,NYK,76,27,49,1362.0,120,79,39,0.658,331,0.363,7,0.37,5.6,343,133,209,0.388,579,0.592,34,0.629,4.1,463,212,248,0.458,864,0.536,41,0.563,4.5,2017-18
316,202713,Kyle Singler,1610612760,OKC,11,5,6,36.0,1,1,0,1.0,5,0.2,1,0.25,7.1,6,0,6,0.0,8,0.75,0,0.75,6.9,7,1,6,0.143,13,0.538,1,0.583,7.0,2017-18
317,202681,Kyrie Irving,1610612738,BOS,57,38,19,1834.0,32,16,17,0.5,135,0.237,6,0.248,9.1,182,27,154,0.148,369,0.493,34,0.543,8.9,214,43,171,0.201,502,0.426,40,0.463,8.9,2017-18
318,200746,LaMarcus Aldridge,1610612759,SAS,75,45,30,2509.0,246,169,73,0.687,538,0.457,7,0.463,5.3,389,126,262,0.324,654,0.595,49,0.643,6.3,635,295,335,0.465,1162,0.546,56,0.574,5.9,2017-18
319,202362,Lance Stephenson,1610612754,IND,82,48,34,1850.0,62,33,28,0.532,256,0.242,8,0.25,8.7,362,57,301,0.157,532,0.68,25,0.714,5.5,424,90,329,0.212,749,0.566,33,0.592,6.0,2017-18
320,202498,Lance Thomas,1610612752,NYK,72,24,48,1328.0,44,23,20,0.523,133,0.331,4,0.341,7.2,129,26,103,0.202,234,0.551,17,0.594,8.7,173,49,123,0.283,354,0.489,21,0.52,8.3,2017-18
321,204038,Langston Galloway,1610612765,DET,58,28,30,863.0,13,2,12,0.154,51,0.255,1,0.26,14.0,79,7,72,0.089,141,0.56,11,0.608,9.5,92,9,84,0.098,189,0.487,12,0.52,10.3,2017-18
322,203580,Larry Drew II,1610612740,NOP,10,6,4,70.0,3,1,2,0.333,6,0.5,1,0.6,9.2,0,0,0,0.0,2,0.0,1,0.0,0.0,3,1,2,0.333,8,0.375,2,0.5,9.2,2017-18
323,1626204,Larry Nance Jr.,1610612739,CLE,66,32,34,1421.0,161,102,56,0.634,350,0.46,11,0.475,6.0,291,90,201,0.309,486,0.599,28,0.635,5.5,452,192,257,0.425,809,0.559,39,0.587,5.7,2017-18
324,1628374,Lauri Markkanen,1610612741,CHI,68,23,45,2020.0,79,45,31,0.57,221,0.357,5,0.366,5.7,429,102,327,0.238,634,0.677,32,0.713,5.4,508,147,358,0.289,817,0.622,37,0.651,5.4,2017-18
325,2544,LeBron James,1610612739,CLE,82,50,32,3026.0,97,46,53,0.474,335,0.29,13,0.301,7.9,612,125,484,0.204,902,0.678,34,0.705,5.7,709,171,537,0.241,1185,0.598,47,0.623,6.0,2017-18
326,1628506,London Perrantes,1610612759,SAS,14,8,6,66.0,1,1,0,1.0,5,0.2,1,0.25,5.6,3,1,2,0.333,5,0.6,2,1.0,9.6,4,2,2,0.5,10,0.4,3,0.571,8.6,2017-18
327,1628366,Lonzo Ball,1610612747,LAL,52,24,28,1780.0,69,35,31,0.507,230,0.3,8,0.311,8.1,291,52,236,0.179,445,0.654,24,0.691,6.9,360,87,267,0.242,661,0.545,32,0.572,7.1,2017-18
328,203485,Lorenzo Brown,1610612761,TOR,14,9,5,139.0,1,0,1,0.0,3,0.333,0,0.333,10.1,14,5,8,0.357,17,0.824,3,1.0,6.5,15,5,9,0.333,20,0.75,3,0.882,6.7,2017-18
329,101150,Lou Williams,1610612746,LAC,79,42,37,2589.0,40,18,24,0.45,193,0.207,7,0.215,10.7,158,21,135,0.133,285,0.554,16,0.587,11.1,198,39,159,0.197,473,0.419,23,0.44,11.1,2017-18
330,201601,Luc Mbah a Moute,1610612745,HOU,61,52,9,1564.0,22,3,19,0.136,117,0.188,7,0.2,13.5,164,64,99,0.39,325,0.505,45,0.586,7.2,186,67,118,0.36,435,0.428,52,0.486,7.9,2017-18
331,203512,Lucas Nogueira,1610612761,TOR,49,36,13,418.0,18,15,4,0.833,44,0.409,1,0.419,4.2,69,20,49,0.29,123,0.561,13,0.627,5.1,87,35,53,0.402,164,0.53,14,0.58,4.9,2017-18
332,1626242,Luis Montero,1610612765,DET,2,1,1,8.0,0,0,0,0.0,2,0.0,0,0.0,0.0,2,2,0,1.0,3,0.667,1,1.0,3.3,2,2,0,1.0,5,0.4,1,0.5,3.3,2017-18
333,202337,Luke Babbitt,1610612748,MIA,49,15,34,690.0,7,0,7,0.0,32,0.219,2,0.233,18.5,87,23,63,0.264,173,0.503,13,0.544,6.1,94,23,70,0.245,194,0.485,15,0.525,7.0,2017-18
334,1628379,Luke Kennard,1610612765,DET,73,34,39,1463.0,21,8,11,0.381,70,0.3,1,0.304,12.8,155,25,131,0.161,276,0.562,22,0.61,8.6,176,33,142,0.188,341,0.516,23,0.553,9.1,2017-18
335,1628436,Luke Kornet,1610612752,NYK,20,6,14,326.0,11,9,2,0.818,40,0.275,0,0.275,3.5,53,21,32,0.396,120,0.442,9,0.477,5.5,64,30,34,0.469,154,0.416,9,0.441,5.2,2017-18
336,2736,Luol Deng,1610612747,LAL,1,0,1,13.0,0,0,0,0.0,0,0.0,0,0.0,0.0,0,0,0,0.0,0,0.0,1,0.0,0.0,0,0,0,0.0,0,0.0,1,0.0,0.0,2017-18
337,1627781,Malachi Richardson,1610612761,TOR,26,8,18,323.0,5,2,3,0.4,20,0.25,0,0.25,17.8,29,7,22,0.241,42,0.69,4,0.763,5.1,34,9,25,0.265,60,0.567,4,0.607,7.0,2017-18
338,1627763,Malcolm Brogdon,1610612749,MIL,47,25,22,1400.0,23,8,16,0.348,97,0.237,4,0.247,12.3,127,25,103,0.197,243,0.523,20,0.57,7.5,150,33,119,0.22,334,0.449,24,0.484,8.4,2017-18
339,1627098,Malcolm Delaney,1610612737,ATL,53,16,37,989.0,9,4,5,0.444,55,0.164,6,0.184,11.8,90,15,74,0.167,168,0.536,12,0.577,8.7,99,19,79,0.192,220,0.45,18,0.49,9.0,2017-18
340,1626259,Malcolm Miller,1610612761,TOR,15,15,0,126.0,4,2,2,0.5,15,0.267,2,0.308,12.9,11,2,9,0.182,18,0.611,2,0.688,8.5,15,4,11,0.267,32,0.469,4,0.536,9.7,2017-18
341,1627736,Malik Beasley,1610612743,DEN,62,34,28,583.0,14,6,8,0.429,31,0.452,0,0.452,12.7,57,11,46,0.193,91,0.626,4,0.655,7.8,71,17,54,0.239,122,0.582,4,0.602,8.8,2017-18
342,1628370,Malik Monk,1610612766,CHA,63,26,37,853.0,8,2,6,0.25,32,0.25,0,0.25,13.0,58,8,50,0.138,98,0.592,6,0.63,9.5,66,10,56,0.152,129,0.512,6,0.537,9.9,2017-18
343,1628493,Mangok Mathiang,1610612766,CHA,4,3,1,20.0,3,2,1,0.667,11,0.273,0,0.273,12.9,7,2,5,0.286,10,0.7,2,0.875,4.6,10,4,6,0.4,19,0.526,2,0.588,7.1,2017-18
344,1938,Manu Ginobili,1610612759,SAS,65,39,26,1299.0,19,8,11,0.421,98,0.194,5,0.204,8.5,123,31,91,0.252,236,0.521,16,0.559,7.3,142,39,102,0.275,326,0.436,21,0.466,7.4,2017-18
345,202705,MarShon Brooks,1610612763,MEM,7,2,5,193.0,8,2,6,0.25,28,0.286,2,0.308,20.0,13,0,13,0.0,24,0.542,2,0.591,7.7,21,2,19,0.095,51,0.412,4,0.447,12.4,2017-18
346,201188,Marc Gasol,1610612763,MEM,73,21,52,2408.0,78,41,37,0.526,257,0.304,8,0.313,10.0,514,170,340,0.331,837,0.614,50,0.653,4.5,592,211,377,0.356,1039,0.57,58,0.603,5.2,2017-18
347,101162,Marcin Gortat,1610612764,WAS,82,43,39,2074.0,181,108,72,0.597,496,0.365,14,0.376,6.6,442,102,334,0.231,791,0.559,75,0.617,4.2,623,210,406,0.337,1238,0.503,89,0.542,4.9,2017-18
348,201158,Marco Belinelli,1610612755,PHI,79,39,40,1921.0,20,3,16,0.15,129,0.155,5,0.161,18.4,127,17,109,0.134,243,0.523,19,0.567,8.1,147,20,125,0.136,363,0.405,24,0.434,9.5,2017-18
349,1627875,Marcus Georges-Hunt,1610612750,MIN,42,24,18,224.0,7,2,5,0.286,12,0.583,1,0.636,11.5,9,2,7,0.222,13,0.692,3,0.9,8.6,16,4,12,0.25,25,0.64,4,0.762,9.9,2017-18
350,202694,Marcus Morris Sr.,1610612738,BOS,52,32,20,1394.0,38,24,15,0.632,151,0.252,6,0.262,9.3,239,53,184,0.222,408,0.586,23,0.621,5.5,277,77,199,0.278,536,0.517,29,0.546,6.1,2017-18
351,1627779,Marcus Paige,1610612766,CHA,5,4,1,28.0,0,0,0,0.0,0,0.0,0,0.0,0.0,4,0,4,0.0,4,1.0,0,1.0,9.6,4,0,4,0.0,4,1.0,0,1.0,9.6,2017-18
352,203935,Marcus Smart,1610612738,BOS,51,35,16,1537.0,42,21,21,0.5,163,0.258,5,0.266,10.1,140,35,106,0.25,271,0.517,20,0.558,7.9,182,56,127,0.308,425,0.428,25,0.455,8.4,2017-18
353,201596,Mario Chalmers,1610612763,MEM,66,21,45,1421.0,13,5,8,0.385,118,0.11,2,0.112,15.0,144,18,126,0.125,265,0.543,23,0.595,9.2,157,23,134,0.146,375,0.419,25,0.449,9.7,2017-18
354,1626209,Mario Hezonja,1610612753,ORL,75,21,54,1657.0,41,19,23,0.463,164,0.25,6,0.259,13.0,240,51,184,0.213,383,0.627,19,0.659,5.7,281,70,207,0.249,524,0.536,25,0.563,6.8,2017-18
355,203900,Markel Brown,1610612745,HOU,4,4,0,31.0,1,0,1,0.0,5,0.2,0,0.2,21.1,4,1,3,0.25,8,0.5,0,0.5,5.5,5,1,4,0.2,13,0.385,0,0.385,8.6,2017-18
356,1628365,Markelle Fultz,1610612755,PHI,14,11,3,253.0,11,5,6,0.455,40,0.275,1,0.282,7.5,32,5,27,0.156,60,0.533,3,0.561,7.8,43,10,33,0.233,98,0.439,4,0.457,7.7,2017-18
357,202693,Markieff Morris,1610612764,WAS,73,37,36,1968.0,75,48,28,0.64,239,0.314,9,0.326,6.8,334,93,240,0.278,538,0.621,27,0.654,5.8,409,141,268,0.345,753,0.543,36,0.57,6.0,2017-18
358,1627737,Marquese Chriss,1610612756,PHX,72,19,53,1527.0,76,51,25,0.671,244,0.311,3,0.315,6.2,319,97,220,0.304,539,0.592,37,0.635,4.4,395,148,245,0.375,732,0.54,40,0.571,4.8,2017-18
359,203104,Marquis Teague,1610612763,MEM,3,0,3,74.0,1,0,1,0.0,3,0.333,0,0.333,25.2,5,0,5,0.0,11,0.455,0,0.455,10.7,6,0,6,0.0,13,0.462,0,0.462,13.1,2017-18
360,201578,Marreese Speights,1610612753,ORL,52,15,37,675.0,21,14,7,0.667,73,0.288,0,0.288,7.0,112,39,71,0.348,217,0.516,18,0.563,4.9,133,53,78,0.398,282,0.472,18,0.504,5.3,2017-18
361,1627850,Marshall Plumlee,1610612749,MIL,8,5,3,52.0,4,3,1,0.75,17,0.235,2,0.267,5.2,13,6,7,0.462,19,0.684,0,0.684,4.4,17,9,8,0.529,35,0.486,2,0.515,4.5,2017-18
362,101107,Marvin Williams,1610612766,CHA,78,33,45,2006.0,74,51,23,0.689,183,0.404,11,0.43,8.3,296,57,236,0.193,488,0.607,33,0.651,7.0,370,108,259,0.292,657,0.563,44,0.604,7.3,2017-18
363,203486,Mason Plumlee,1610612743,DEN,74,40,34,1439.0,132,88,39,0.667,368,0.359,9,0.368,5.4,268,79,184,0.295,448,0.598,28,0.638,4.6,400,167,223,0.418,799,0.501,37,0.525,4.9,2017-18
364,1627856,Matt Costello,1610612759,SAS,4,2,2,32.0,1,1,0,1.0,4,0.25,0,0.25,2.1,8,4,3,0.5,12,0.667,1,0.727,5.0,9,5,3,0.556,15,0.6,1,0.643,4.7,2017-18
365,1628475,Matt Williams Jr.,1610612748,MIA,3,1,2,11.0,0,0,0,0.0,0,0.0,0,0.0,0.0,1,0,1,0.0,2,0.5,0,0.5,3.7,1,0,1,0.0,2,0.5,0,0.5,3.7,2017-18
366,203521,Matthew Dellavedova,1610612749,MIL,37,21,16,691.0,14,2,13,0.143,43,0.326,3,0.35,14.8,48,9,38,0.188,103,0.466,12,0.527,8.8,62,11,51,0.177,145,0.428,15,0.477,10.3,2017-18
367,203090,Maurice Harkless,1610612757,POR,59,36,23,1264.0,46,29,17,0.63,152,0.303,4,0.311,6.4,116,34,83,0.293,213,0.545,16,0.589,6.4,162,63,100,0.389,350,0.463,20,0.491,6.4,2017-18
368,1628467,Maxi Kleber,1610612742,DAL,72,20,52,1206.0,71,39,30,0.549,178,0.399,5,0.41,7.8,163,56,108,0.344,293,0.556,22,0.601,5.2,234,95,138,0.406,452,0.518,27,0.551,6.0,2017-18
369,203086,Meyers Leonard,1610612757,POR,33,17,16,254.0,12,10,1,0.833,32,0.375,1,0.387,6.3,58,16,42,0.276,82,0.707,6,0.763,4.7,70,26,43,0.371,107,0.654,7,0.7,4.9,2017-18
370,201563,Michael Beasley,1610612752,NYK,73,23,50,1616.0,97,63,31,0.649,233,0.416,9,0.433,6.1,312,90,218,0.288,500,0.624,25,0.657,4.5,409,153,249,0.374,703,0.582,34,0.611,4.8,2017-18
371,203487,Michael Carter-Williams,1610612766,CHA,52,23,29,835.0,37,15,23,0.405,111,0.333,2,0.339,11.1,101,14,87,0.139,186,0.543,14,0.587,7.5,138,29,110,0.21,292,0.473,16,0.5,8.4,2017-18
372,203077,Michael Kidd-Gilchrist,1610612766,CHA,74,34,40,1850.0,84,46,37,0.548,244,0.344,9,0.357,8.0,218,45,173,0.206,403,0.541,35,0.592,8.3,302,91,210,0.301,640,0.472,44,0.507,8.2,2017-18
373,201144,Mike Conley,1610612763,MEM,12,7,5,373.0,0,0,0,0.0,13,0.0,1,0.0,0.0,27,1,26,0.037,51,0.529,7,0.614,10.8,27,1,26,0.037,63,0.429,8,0.491,10.8,2017-18
374,1628455,Mike James,1610612756,PHX,36,11,25,686.0,13,4,9,0.308,58,0.224,2,0.232,8.9,77,7,70,0.091,156,0.494,14,0.542,9.8,90,11,79,0.122,212,0.425,16,0.459,9.7,2017-18
375,203488,Mike Muscala,1610612737,ATL,53,14,39,1060.0,56,39,16,0.696,139,0.403,1,0.406,7.1,174,67,105,0.385,314,0.554,20,0.592,5.2,230,106,121,0.461,439,0.524,21,0.55,5.6,2017-18
376,203118,Mike Scott,1610612764,WAS,76,39,37,1406.0,50,26,22,0.52,154,0.325,7,0.34,5.9,197,47,148,0.239,323,0.61,16,0.642,6.1,247,73,170,0.296,455,0.543,23,0.572,6.1,2017-18
377,203101,Miles Plumlee,1610612737,ATL,55,19,36,918.0,77,45,31,0.584,211,0.365,9,0.381,7.2,151,49,102,0.325,309,0.489,44,0.57,4.9,228,94,133,0.412,508,0.449,53,0.501,5.7,2017-18
378,1628462,Milos Teodosic,1610612746,LAC,45,29,16,1134.0,16,4,11,0.25,71,0.225,3,0.235,14.1,110,15,95,0.136,239,0.46,20,0.502,8.3,126,19,106,0.151,310,0.406,23,0.439,9.0,2017-18
379,1628495,Milton Doyle,1610612751,BKN,10,2,8,125.0,3,1,2,0.333,12,0.25,0,0.25,18.5,15,1,14,0.067,28,0.536,5,0.652,6.8,18,2,16,0.111,40,0.45,5,0.514,8.7,2017-18
380,1627851,Mindaugas Kuzminskas,1610612752,NYK,1,0,1,2.0,0,0,0,0.0,0,0.0,0,0.0,0.0,0,0,0,0.0,0,0.0,1,0.0,0.0,0,0,0,0.0,0,0.0,1,0.0,0.0,2017-18
381,203141,Mirza Teletovic,1610612749,MIL,9,4,5,142.0,3,1,2,0.333,7,0.429,0,0.429,8.1,17,1,16,0.059,35,0.486,1,0.5,4.8,20,2,18,0.1,42,0.476,1,0.488,5.3,2017-18
382,1628420,Monte Morris,1610612743,DEN,3,2,1,25.0,0,0,0,0.0,2,0.0,1,0.0,0.0,2,0,2,0.0,2,1.0,0,1.0,16.7,2,0,2,0.0,4,0.5,1,0.667,16.7,2017-18
383,1626149,Montrezl Harrell,1610612746,LAC,76,39,37,1293.0,103,74,29,0.718,257,0.401,6,0.41,6.3,203,72,130,0.355,366,0.555,24,0.594,5.8,306,146,159,0.477,597,0.513,30,0.54,5.9,2017-18
384,1627988,Myke Henry,1610612763,MEM,20,3,17,378.0,10,4,6,0.4,38,0.263,1,0.27,15.4,28,7,21,0.25,62,0.452,11,0.549,7.1,38,11,27,0.289,96,0.396,12,0.452,9.3,2017-18
385,1626167,Myles Turner,1610612754,IND,65,39,26,1836.0,93,62,32,0.667,242,0.384,9,0.399,6.2,324,129,193,0.398,645,0.502,48,0.543,4.4,417,191,225,0.458,858,0.486,57,0.521,4.8,2017-18
386,203489,Nate Wolters,1610612762,UTA,5,3,2,19.0,1,0,1,0.0,1,1.0,0,1.0,13.4,1,0,0,0.0,1,1.0,0,1.0,0.0,2,0,1,0.0,2,1.0,0,1.0,13.4,2017-18
387,1628513,Naz Mitrou-Long,1610612762,UTA,1,0,1,1.0,0,0,0,0.0,0,0.0,0,0.0,0.0,0,0,0,0.0,0,0.0,0,0.0,0.0,0,0,0,0.0,0,0.0,0,0.0,0.0,2017-18
388,202357,Nemanja Bjelica,1610612750,MIN,67,38,29,1371.0,53,35,17,0.66,141,0.376,2,0.381,6.2,221,67,153,0.303,361,0.612,26,0.66,5.8,274,102,170,0.372,486,0.564,28,0.598,5.9,2017-18
389,2403,Nene,1610612745,HOU,52,42,10,758.0,54,37,17,0.685,158,0.342,2,0.346,5.8,122,34,87,0.279,219,0.557,19,0.61,4.7,176,71,104,0.403,367,0.48,21,0.509,5.1,2017-18
390,203457,Nerlens Noel,1610612742,DAL,30,6,24,472.0,48,38,9,0.792,127,0.378,3,0.387,4.9,120,41,78,0.342,191,0.628,19,0.698,3.9,168,79,87,0.47,307,0.547,22,0.589,4.2,2017-18
391,2555,Nick Collison,1610612760,OKC,13,9,4,58.0,5,3,2,0.6,16,0.313,1,0.333,4.1,11,0,10,0.0,19,0.579,1,0.611,4.6,16,3,12,0.188,33,0.485,2,0.516,4.4,2017-18
392,201156,Nick Young,1610612744,GSW,80,56,24,1393.0,20,5,16,0.25,58,0.345,2,0.357,14.5,105,21,84,0.2,192,0.547,15,0.593,9.0,125,26,100,0.208,247,0.506,17,0.543,10.1,2017-18
393,201587,Nicolas Batum,1610612766,CHA,64,27,37,1981.0,57,30,27,0.526,162,0.352,4,0.361,8.6,249,42,207,0.169,385,0.647,31,0.703,6.8,306,72,234,0.235,533,0.574,35,0.614,7.1,2017-18
394,1627852,Nicolas Brussino,1610612737,ATL,4,0,4,10.0,0,0,0,0.0,0,0.0,0,0.0,0.0,3,0,3,0.0,3,1.0,0,1.0,7.0,3,0,3,0.0,3,1.0,0,1.0,7.0,2017-18
395,1628502,Nigel Hayes,1610612758,SAC,9,6,3,122.0,4,2,2,0.5,14,0.286,0,0.286,11.1,18,6,12,0.333,24,0.75,0,0.75,7.0,22,8,14,0.364,34,0.647,0,0.647,7.7,2017-18
396,203917,Nik Stauskas,1610612751,BKN,41,14,27,523.0,4,1,3,0.25,24,0.167,0,0.167,8.9,60,7,53,0.117,94,0.638,7,0.69,7.0,64,8,56,0.125,116,0.552,7,0.587,7.1,2017-18
397,203999,Nikola Jokic,1610612743,DEN,75,43,32,2443.0,195,147,40,0.754,438,0.445,8,0.453,5.5,608,200,405,0.329,938,0.648,47,0.682,4.2,803,347,445,0.432,1312,0.612,55,0.639,4.5,2017-18
398,202703,Nikola Mirotic,1610612740,NOP,55,34,21,1494.0,59,39,18,0.661,177,0.333,6,0.345,6.2,346,81,263,0.234,531,0.652,29,0.689,5.2,405,120,281,0.296,661,0.613,35,0.647,5.4,2017-18
399,202696,Nikola Vucevic,1610612753,ORL,57,17,40,1683.0,101,66,32,0.653,244,0.414,2,0.417,7.1,422,157,262,0.372,620,0.681,36,0.723,3.9,523,223,294,0.426,830,0.63,38,0.66,4.5,2017-18
400,203943,Noah Vonleh,1610612741,CHI,54,24,30,876.0,70,52,18,0.743,182,0.385,3,0.391,5.9,241,81,159,0.336,367,0.657,16,0.687,3.8,311,133,177,0.428,535,0.581,19,0.603,4.3,2017-18
401,1626181,Norman Powell,1610612761,TOR,70,51,19,1062.0,14,6,7,0.429,66,0.212,6,0.233,16.2,105,20,83,0.19,173,0.607,15,0.665,6.3,119,26,90,0.218,230,0.517,21,0.569,7.4,2017-18
402,1628384,OG Anunoby,1610612761,TOR,74,51,23,1481.0,44,21,23,0.477,121,0.364,3,0.373,9.1,140,32,105,0.229,219,0.639,20,0.704,6.3,184,53,128,0.288,330,0.558,23,0.599,7.0,2017-18
403,1627855,Okaro White,1610612739,CLE,6,2,4,80.0,3,2,1,0.667,9,0.333,1,0.375,6.8,8,3,5,0.375,17,0.471,1,0.5,5.7,11,5,6,0.455,26,0.423,2,0.458,6.0,2017-18
404,204179,Omari Johnson,1610612763,MEM,4,1,3,75.0,4,3,1,0.75,8,0.5,1,0.571,6.0,7,1,6,0.143,20,0.35,2,0.389,8.3,11,4,7,0.364,28,0.393,3,0.44,7.5,2017-18
405,201600,Omer Asik,1610612741,CHI,18,7,11,182.0,9,5,4,0.556,19,0.474,0,0.474,5.8,38,10,28,0.263,68,0.559,9,0.644,4.5,47,15,32,0.319,84,0.56,9,0.627,4.8,2017-18
406,201956,Omri Casspi,1610612744,GSW,53,40,13,742.0,30,21,10,0.7,106,0.283,4,0.294,3.8,170,29,140,0.171,285,0.596,22,0.646,4.6,200,50,150,0.25,374,0.535,26,0.575,4.5,2017-18
407,203490,Otto Porter Jr.,1610612764,WAS,77,42,35,2432.0,103,61,41,0.592,323,0.319,15,0.334,8.8,389,92,294,0.237,638,0.61,34,0.644,6.6,492,153,335,0.311,932,0.528,49,0.557,7.0,2017-18
408,200782,P.J. Tucker,1610612745,HOU,82,65,17,2281.0,93,55,37,0.591,276,0.337,4,0.342,8.4,364,91,272,0.25,613,0.594,44,0.64,6.1,457,146,309,0.319,848,0.539,48,0.571,6.5,2017-18
409,1628408,PJ Dozier,1610612760,OKC,2,1,1,3.0,0,0,0,0.0,0,0.0,0,0.0,0.0,1,0,1,0.0,1,1.0,0,1.0,6.6,1,0,1,0.0,1,1.0,0,1.0,6.6,2017-18
410,1627783,Pascal Siakam,1610612761,TOR,81,59,22,1679.0,79,44,35,0.557,234,0.338,8,0.35,8.3,285,88,197,0.309,500,0.57,27,0.603,5.7,364,132,232,0.363,693,0.525,35,0.553,6.3,2017-18
411,1626192,Pat Connaughton,1610612757,POR,82,49,33,1488.0,36,15,21,0.417,107,0.336,6,0.356,12.8,125,20,105,0.16,218,0.573,27,0.654,8.1,161,35,126,0.217,317,0.508,33,0.567,9.2,2017-18
412,201976,Patrick Beverley,1610612746,LAC,11,5,6,334.0,16,4,12,0.25,48,0.333,3,0.356,11.6,29,6,22,0.207,51,0.569,1,0.58,7.6,45,10,34,0.222,98,0.459,4,0.479,9.1,2017-18
413,1627775,Patrick McCaw,1610612744,GSW,57,41,16,961.0,16,3,14,0.188,63,0.254,2,0.262,13.2,66,12,54,0.182,122,0.541,6,0.569,7.9,82,15,68,0.183,182,0.451,8,0.471,9.0,2017-18
414,202335,Patrick Patterson,1610612760,OKC,80,48,32,1225.0,31,17,15,0.548,91,0.341,3,0.352,9.7,155,49,106,0.316,288,0.538,20,0.578,5.8,186,66,121,0.355,372,0.5,23,0.533,6.4,2017-18
415,201988,Patty Mills,1610612759,SAS,82,47,35,2107.0,26,7,19,0.269,104,0.25,4,0.26,15.8,128,11,117,0.086,227,0.564,18,0.612,11.6,154,18,136,0.117,329,0.468,22,0.502,12.3,2017-18
416,2200,Pau Gasol,1610612759,SAS,77,45,32,1812.0,129,88,40,0.682,343,0.376,8,0.385,6.3,490,163,328,0.333,757,0.647,44,0.687,4.0,619,251,368,0.405,1057,0.586,52,0.616,4.5,2017-18
417,202331,Paul George,1610612760,OKC,78,47,31,2854.0,68,29,40,0.426,283,0.24,8,0.247,14.6,370,72,298,0.195,654,0.566,54,0.617,6.9,438,101,338,0.231,916,0.478,62,0.513,8.1,2017-18
418,200794,Paul Millsap,1610612743,DEN,38,22,16,1143.0,65,38,25,0.585,145,0.448,2,0.455,7.6,180,60,113,0.333,336,0.536,28,0.584,5.6,245,98,138,0.4,470,0.521,30,0.557,6.1,2017-18
419,1627835,Paul Zipser,1610612741,CHI,54,17,37,824.0,13,8,5,0.615,71,0.183,2,0.188,9.4,118,28,89,0.237,203,0.581,18,0.638,5.0,131,36,94,0.275,262,0.5,20,0.541,5.4,2017-18
420,203112,Quincy Acy,1610612751,BKN,68,25,43,1323.0,39,11,28,0.282,123,0.317,3,0.325,11.2,214,46,166,0.215,400,0.535,29,0.577,5.1,253,57,194,0.225,497,0.509,32,0.544,6.0,2017-18
421,202347,Quincy Pondexter,1610612741,CHI,23,6,17,196.0,8,6,2,0.75,21,0.381,0,0.381,7.2,19,2,17,0.105,38,0.5,6,0.594,7.9,27,8,19,0.296,57,0.474,6,0.529,7.7,2017-18
422,1626188,Quinn Cook,1610612744,GSW,33,21,12,741.0,10,2,8,0.2,56,0.179,1,0.182,25.1,72,9,63,0.125,150,0.48,13,0.526,8.0,82,11,71,0.134,203,0.404,14,0.434,10.1,2017-18
423,1626154,RJ Hunter,1610612745,HOU,5,3,2,45.0,0,0,0,0.0,1,0.0,0,0.0,0.0,5,2,3,0.4,6,0.833,2,1.25,7.8,5,2,3,0.4,7,0.714,2,1.0,7.8,2017-18
424,200765,Rajon Rondo,1610612740,NOP,65,41,24,1705.0,31,12,19,0.387,166,0.187,5,0.193,11.0,232,25,206,0.108,412,0.563,24,0.598,8.4,263,37,225,0.141,569,0.462,29,0.487,8.7,2017-18
425,201196,Ramon Sessions,1610612764,WAS,28,10,18,392.0,6,1,5,0.167,16,0.375,1,0.4,14.8,32,0,32,0.0,57,0.561,3,0.593,9.3,38,1,37,0.026,72,0.528,4,0.559,10.2,2017-18
426,1626173,Rashad Vaughn,1610612749,MIL,28,13,15,212.0,3,1,2,0.333,5,0.6,0,0.6,18.4,18,4,14,0.222,36,0.5,3,0.545,8.3,21,5,16,0.238,41,0.512,3,0.553,9.8,2017-18
427,203526,Raul Neto,1610612762,UTA,41,28,13,498.0,7,1,6,0.143,38,0.184,1,0.189,14.4,42,2,40,0.048,84,0.5,9,0.56,9.9,49,3,46,0.061,122,0.402,10,0.438,10.6,2017-18
428,101109,Raymond Felton,1610612760,OKC,80,48,32,1335.0,24,7,14,0.292,95,0.253,5,0.267,11.5,128,23,104,0.18,222,0.577,24,0.646,9.0,152,30,118,0.197,313,0.486,29,0.535,9.3,2017-18
429,203493,Reggie Bullock,1610612765,DET,62,32,30,1732.0,27,14,14,0.519,94,0.287,5,0.303,11.1,127,30,97,0.236,225,0.564,18,0.614,8.8,154,44,111,0.286,313,0.492,23,0.531,9.2,2017-18
430,203687,Reggie Hearn,1610612765,DET,3,3,0,7.0,0,0,0,0.0,0,0.0,0,0.0,0.0,0,0,0,0.0,0,0.0,0,0.0,0.0,0,0,0,0.0,0,0.0,0,0.0,0.0,2017-18
431,202704,Reggie Jackson,1610612765,DET,45,27,18,1201.0,29,11,18,0.379,114,0.254,7,0.271,12.9,96,11,85,0.115,186,0.516,25,0.596,8.7,125,22,103,0.176,299,0.418,32,0.468,9.7,2017-18
432,2210,Richard Jefferson,1610612743,DEN,20,10,10,163.0,2,1,1,0.5,14,0.143,0,0.143,2.1,15,3,12,0.2,29,0.517,5,0.625,6.9,17,4,13,0.235,39,0.436,5,0.5,6.4,2017-18
433,1626158,Richaun Holmes,1610612755,PHI,47,30,17,728.0,57,36,21,0.632,170,0.335,5,0.345,8.7,150,53,96,0.353,268,0.56,17,0.598,4.5,207,89,117,0.43,421,0.492,22,0.519,5.7,2017-18
434,201937,Ricky Rubio,1610612762,UTA,77,44,33,2254.0,44,12,32,0.273,208,0.212,2,0.214,14.3,307,43,262,0.14,502,0.612,40,0.665,8.6,351,55,294,0.157,702,0.5,42,0.532,9.3,2017-18
435,203496,Robert Covington,1610612755,PHI,79,51,28,2501.0,54,23,31,0.426,195,0.277,10,0.292,11.2,376,96,279,0.255,699,0.538,60,0.588,6.9,430,119,310,0.277,875,0.491,70,0.534,7.4,2017-18
436,201577,Robin Lopez,1610612741,CHI,64,23,41,1690.0,134,96,34,0.716,354,0.379,6,0.385,5.0,156,61,95,0.391,346,0.451,57,0.54,5.8,290,157,129,0.541,687,0.422,63,0.465,5.4,2017-18
437,203918,Rodney Hood,1610612739,CLE,60,29,31,1615.0,22,5,17,0.227,91,0.242,2,0.247,13.7,143,16,126,0.112,256,0.559,20,0.606,8.6,165,21,143,0.127,334,0.494,22,0.529,9.3,2017-18
438,203585,Rodney McGruder,1610612748,MIA,18,11,7,299.0,11,4,7,0.364,34,0.324,1,0.333,7.4,22,1,20,0.045,47,0.468,3,0.5,6.2,33,5,27,0.152,81,0.407,4,0.429,6.6,2017-18
439,1628681,Rodney Purvis,1610612753,ORL,16,5,11,290.0,1,0,1,0.0,11,0.091,0,0.091,12.4,26,3,22,0.115,45,0.578,1,0.591,6.8,27,3,23,0.111,56,0.482,1,0.491,7.0,2017-18
440,1627758,Ron Baker,1610612752,NYK,28,11,17,367.0,5,1,4,0.2,16,0.313,1,0.333,16.9,24,4,20,0.167,49,0.49,2,0.511,9.9,29,5,24,0.172,64,0.453,3,0.475,11.1,2017-18
441,1626178,Rondae Hollis-Jefferson,1610612751,BKN,66,25,41,1851.0,99,64,35,0.646,321,0.308,9,0.317,6.2,348,106,239,0.305,618,0.563,53,0.616,4.9,447,170,274,0.38,891,0.502,62,0.539,5.2,2017-18
442,1626220,Royce O'Neale,1610612762,UTA,69,43,26,1150.0,25,10,16,0.4,82,0.305,2,0.313,8.4,211,64,144,0.303,328,0.643,25,0.696,5.3,236,74,160,0.314,399,0.591,27,0.634,5.7,2017-18
443,200752,Rudy Gay,1610612759,SAS,57,36,21,1231.0,76,42,30,0.553,186,0.409,5,0.42,7.3,215,59,156,0.274,397,0.542,33,0.591,5.1,291,101,186,0.347,562,0.518,38,0.555,5.7,2017-18
444,203497,Rudy Gobert,1610612762,UTA,56,37,19,1816.0,165,113,51,0.685,452,0.365,8,0.372,5.1,436,127,304,0.291,772,0.565,61,0.613,3.8,601,240,355,0.399,1187,0.506,69,0.538,4.1,2017-18
445,201566,Russell Westbrook,1610612760,OKC,78,47,31,2843.0,150,70,81,0.467,544,0.276,25,0.289,10.0,639,100,542,0.156,911,0.701,36,0.73,6.6,789,170,623,0.215,1373,0.575,61,0.601,7.3,2017-18
446,201583,Ryan Anderson,1610612745,HOU,66,52,14,1725.0,94,64,30,0.681,232,0.405,7,0.418,7.1,237,81,156,0.342,409,0.579,27,0.62,5.6,331,145,186,0.438,623,0.531,34,0.562,6.1,2017-18
447,1627853,Ryan Arcidiacono,1610612741,CHI,24,6,18,304.0,1,0,1,0.0,12,0.083,0,0.083,10.6,24,2,22,0.083,35,0.686,2,0.727,8.3,25,2,23,0.08,45,0.556,2,0.581,8.4,2017-18
448,1626257,Salah Mejri,1610612742,DAL,61,21,40,729.0,85,61,24,0.718,208,0.409,3,0.415,6.8,161,60,100,0.373,287,0.561,23,0.61,4.1,246,121,124,0.492,476,0.517,26,0.547,5.1,2017-18
449,1626155,Sam Dekker,1610612746,LAC,73,36,37,883.0,44,28,16,0.636,132,0.333,4,0.344,7.6,130,30,101,0.231,235,0.553,21,0.607,5.8,174,58,117,0.333,352,0.494,25,0.532,6.3,2017-18
450,203816,Scotty Hopson,1610612742,DAL,1,0,1,8.0,0,0,0,0.0,0,0.0,0,0.0,0.0,0,0,0,0.0,0,0.0,0,0.0,0.0,0,0,0,0.0,0,0.0,0,0.0,0.0,2017-18
451,203930,Sean Kilpatrick,1610612741,CHI,52,22,30,640.0,5,1,4,0.2,41,0.122,4,0.135,13.6,82,9,73,0.11,123,0.667,12,0.739,7.6,87,10,77,0.115,161,0.54,16,0.6,8.0,2017-18
452,1628400,Semi Ojeleye,1610612738,BOS,70,47,23,1132.0,36,13,23,0.361,97,0.371,2,0.379,12.4,124,44,80,0.355,225,0.551,18,0.599,7.7,160,57,103,0.356,304,0.526,20,0.563,8.7,2017-18
453,201586,Serge Ibaka,1610612761,TOR,76,53,23,2093.0,78,51,28,0.654,252,0.31,6,0.317,6.1,400,104,293,0.26,689,0.581,54,0.63,4.2,478,155,321,0.324,902,0.53,60,0.568,4.6,2017-18
454,203498,Shabazz Muhammad,1610612749,MIL,43,25,18,418.0,23,19,4,0.826,72,0.319,2,0.329,5.5,53,15,38,0.283,79,0.671,4,0.707,4.4,76,34,42,0.447,144,0.528,6,0.551,4.7,2017-18
455,203894,Shabazz Napier,1610612757,POR,74,46,28,1535.0,26,8,18,0.308,121,0.215,1,0.217,14.3,144,12,131,0.083,287,0.502,34,0.569,8.5,170,20,149,0.118,404,0.421,35,0.461,9.4,2017-18
456,203499,Shane Larkin,1610612738,BOS,51,36,15,743.0,15,5,10,0.333,52,0.288,4,0.313,11.3,75,11,64,0.147,126,0.595,9,0.641,8.4,90,16,74,0.178,177,0.508,13,0.549,8.9,2017-18
457,1627885,Shaquille Harrison,1610612756,PHX,23,3,20,384.0,9,3,6,0.333,53,0.17,1,0.173,9.1,52,10,42,0.192,86,0.605,5,0.642,8.9,61,13,48,0.213,139,0.439,6,0.459,9.0,2017-18
458,2733,Shaun Livingston,1610612744,GSW,71,49,22,1129.0,32,11,21,0.344,80,0.4,5,0.427,10.1,99,22,77,0.222,189,0.524,18,0.579,8.6,131,33,98,0.252,266,0.492,23,0.539,9.1,2017-18
459,202714,Shelvin Mack,1610612753,ORL,69,21,48,1365.0,23,3,23,0.13,86,0.267,5,0.284,12.5,143,15,125,0.105,253,0.565,19,0.611,9.4,166,18,148,0.108,329,0.505,24,0.544,9.9,2017-18
460,1628414,Sindarius Thornwell,1610612746,LAC,73,36,37,1156.0,33,9,23,0.273,107,0.308,2,0.314,10.7,107,33,75,0.308,204,0.525,24,0.594,7.4,140,42,98,0.3,307,0.456,26,0.498,8.2,2017-18
461,1627746,Skal Labissiere,1610612758,SAC,60,19,41,1240.0,98,68,29,0.694,244,0.402,6,0.412,5.9,189,58,127,0.307,355,0.532,33,0.587,5.4,287,126,156,0.439,584,0.491,39,0.527,5.6,2017-18
462,203524,Solomon Hill,1610612740,NOP,12,8,4,187.0,9,4,5,0.444,22,0.409,2,0.45,5.3,27,5,22,0.185,45,0.6,3,0.643,8.4,36,9,27,0.25,65,0.554,5,0.6,7.6,2017-18
463,203915,Spencer Dinwiddie,1610612751,BKN,78,27,51,2255.0,39,13,26,0.333,144,0.271,3,0.277,14.5,213,28,184,0.131,354,0.602,20,0.638,8.3,252,41,210,0.163,484,0.521,23,0.547,9.3,2017-18
464,1626169,Stanley Johnson,1610612765,DET,69,33,36,1893.0,33,21,13,0.636,132,0.25,3,0.256,9.6,219,42,176,0.192,392,0.559,33,0.61,7.4,252,63,189,0.25,515,0.489,36,0.526,7.7,2017-18
465,201939,Stephen Curry,1610612744,GSW,51,41,10,1631.0,36,11,25,0.306,148,0.243,4,0.25,13.2,225,38,187,0.169,406,0.554,33,0.603,8.5,261,49,212,0.188,550,0.475,37,0.509,9.1,2017-18
466,1628425,Sterling Brown,1610612749,MIL,54,26,28,776.0,27,11,16,0.407,62,0.435,2,0.45,13.2,116,22,91,0.19,192,0.604,20,0.674,5.9,143,33,107,0.231,251,0.57,22,0.624,7.3,2017-18
467,203500,Steven Adams,1610612760,OKC,75,43,32,2457.0,375,262,104,0.699,799,0.469,19,0.481,5.3,296,109,187,0.368,596,0.497,49,0.541,5.4,671,371,291,0.553,1375,0.488,68,0.513,5.4,2017-18
468,1628388,T.J. Leaf,1610612754,IND,53,31,22,459.0,29,16,13,0.552,73,0.397,2,0.408,7.5,53,13,36,0.245,97,0.546,10,0.609,5.7,82,29,49,0.354,167,0.491,12,0.529,6.4,2017-18
469,204456,T.J. McConnell,1610612755,PHI,75,50,25,1680.0,37,13,26,0.351,131,0.282,4,0.291,14.4,185,21,161,0.114,306,0.605,19,0.645,9.1,222,34,187,0.153,425,0.522,23,0.552,10.0,2017-18
470,203933,T.J. Warren,1610612756,PHX,65,18,47,2142.0,125,87,39,0.696,321,0.389,8,0.399,6.3,208,66,139,0.317,362,0.575,21,0.61,8.3,333,153,178,0.459,659,0.505,29,0.529,7.6,2017-18
471,201959,Taj Gibson,1610612750,MIN,82,47,35,2726.0,194,132,62,0.68,511,0.38,17,0.393,6.6,390,98,291,0.251,717,0.544,44,0.579,5.6,584,230,353,0.394,1187,0.492,61,0.519,5.9,2017-18
472,204028,Tarik Black,1610612745,HOU,51,40,11,536.0,63,45,17,0.714,152,0.414,2,0.42,5.4,100,32,67,0.32,171,0.585,14,0.637,5.1,163,77,84,0.472,306,0.533,16,0.562,5.2,2017-18
473,1627752,Taurean Prince,1610612737,ATL,81,24,57,2431.0,49,16,34,0.327,181,0.271,6,0.28,13.1,335,71,263,0.212,567,0.591,49,0.647,6.4,384,87,297,0.227,734,0.523,55,0.566,7.3,2017-18
474,1628390,Terrance Ferguson,1610612760,OKC,59,37,22,742.0,19,8,12,0.421,33,0.576,3,0.633,14.6,28,8,19,0.286,63,0.444,5,0.483,9.9,47,16,31,0.34,96,0.49,8,0.534,12.3,2017-18
475,203082,Terrence Ross,1610612753,ORL,24,10,14,600.0,10,2,8,0.2,40,0.25,1,0.256,16.4,63,9,52,0.143,107,0.589,7,0.63,8.0,73,11,60,0.151,143,0.51,8,0.541,9.2,2017-18
476,1626179,Terry Rozier,1610612738,BOS,77,51,26,2001.0,61,30,32,0.492,185,0.33,7,0.343,10.5,299,55,244,0.184,524,0.571,47,0.627,7.2,360,85,276,0.236,703,0.512,54,0.555,7.7,2017-18
477,200757,Thabo Sefolosha,1610612762,UTA,38,16,22,806.0,29,11,17,0.379,90,0.322,4,0.337,10.8,132,37,95,0.28,216,0.611,16,0.66,5.9,161,48,112,0.298,294,0.548,20,0.588,6.7,2017-18
478,201152,Thaddeus Young,1610612754,IND,81,48,33,2607.0,184,119,65,0.647,447,0.412,5,0.416,5.3,328,88,241,0.268,587,0.559,43,0.603,6.6,512,207,306,0.404,1008,0.508,48,0.533,6.2,2017-18
479,1628418,Thomas Bryant,1610612747,LAL,15,7,8,72.0,3,1,2,0.333,9,0.333,1,0.375,10.4,14,6,8,0.429,20,0.7,1,0.737,4.5,17,7,10,0.412,26,0.654,2,0.708,5.5,2017-18
480,1627748,Thon Maker,1610612749,MIL,73,40,33,1224.0,74,42,31,0.568,195,0.379,3,0.385,7.3,148,48,100,0.324,336,0.44,35,0.492,6.2,222,90,131,0.405,509,0.436,38,0.471,6.6,2017-18
481,204025,Tim Frazier,1610612764,WAS,59,31,28,838.0,18,6,12,0.333,69,0.261,1,0.265,13.2,97,11,85,0.113,178,0.545,24,0.63,8.8,115,17,97,0.148,240,0.479,25,0.535,9.5,2017-18
482,203501,Tim Hardaway Jr.,1610612752,NYK,57,19,38,1885.0,32,14,19,0.438,180,0.178,5,0.183,13.1,192,21,167,0.109,340,0.565,27,0.613,8.3,224,35,186,0.156,505,0.444,32,0.474,9.0,2017-18
483,1627817,Tim Quarterman,1610612745,HOU,3,2,1,13.0,0,0,0,0.0,1,0.0,0,0.0,0.0,3,2,1,0.667,3,1.0,0,1.0,6.1,3,2,1,0.667,4,0.75,0,0.75,6.1,2017-18
484,202389,Timofey Mozgov,1610612751,BKN,29,11,18,346.0,31,20,11,0.645,71,0.437,1,0.443,5.2,63,22,42,0.349,110,0.573,11,0.636,4.2,94,42,53,0.447,178,0.528,12,0.566,4.5,2017-18
485,1627789,Timothe Luwawu-Cabarrot,1610612755,PHI,51,29,22,795.0,14,7,8,0.5,72,0.194,4,0.206,9.1,58,9,50,0.155,129,0.45,13,0.5,8.5,72,16,58,0.222,198,0.364,17,0.398,8.6,2017-18
486,202699,Tobias Harris,1610612746,LAC,80,39,41,2668.0,58,33,23,0.569,241,0.241,7,0.248,8.0,379,95,284,0.251,696,0.545,54,0.59,5.8,437,128,307,0.293,910,0.48,61,0.515,6.1,2017-18
487,203107,Tomas Satoransky,1610612764,WAS,73,39,34,1643.0,72,39,33,0.542,202,0.356,8,0.371,9.9,161,28,129,0.174,286,0.563,21,0.608,9.1,233,67,162,0.288,480,0.485,29,0.517,9.4,2017-18
488,2754,Tony Allen,1610612740,NOP,22,12,10,273.0,20,10,9,0.5,55,0.364,0,0.364,5.9,27,4,23,0.148,41,0.659,1,0.675,6.2,47,14,32,0.298,92,0.511,1,0.516,6.1,2017-18
489,1628396,Tony Bradley,1610612762,UTA,9,6,3,29.0,4,3,1,0.75,6,0.667,1,0.8,3.2,7,4,3,0.571,13,0.538,2,0.636,3.4,11,7,4,0.636,18,0.611,3,0.733,3.4,2017-18
490,2225,Tony Parker,1610612759,SAS,55,32,23,1071.0,7,2,4,0.286,53,0.132,3,0.14,14.7,88,9,79,0.102,138,0.638,13,0.704,10.0,95,11,83,0.116,189,0.503,16,0.549,10.3,2017-18
491,203503,Tony Snell,1610612749,MIL,74,42,32,2028.0,9,1,9,0.111,49,0.184,1,0.188,15.9,131,18,113,0.137,268,0.489,26,0.541,8.9,140,19,122,0.136,312,0.449,27,0.491,9.4,2017-18
492,1628470,Torrey Craig,1610612743,DEN,39,22,17,629.0,40,26,12,0.65,109,0.367,2,0.374,8.3,87,22,65,0.253,157,0.554,14,0.608,6.1,127,48,77,0.378,253,0.502,16,0.536,6.8,2017-18
493,204037,Travis Wear,1610612747,LAL,17,7,10,228.0,0,0,0,0.0,12,0.0,1,0.0,0.0,38,14,22,0.368,61,0.623,7,0.704,6.6,38,14,22,0.368,69,0.551,8,0.623,6.6,2017-18
494,1626203,Treveon Graham,1610612766,CHA,63,28,35,1050.0,42,30,12,0.714,110,0.382,3,0.393,5.5,79,20,59,0.253,177,0.446,18,0.497,8.6,121,50,71,0.413,282,0.429,21,0.464,7.5,2017-18
495,2772,Trevor Ariza,1610612745,HOU,67,51,16,2269.0,33,19,14,0.576,173,0.191,7,0.199,11.1,261,48,212,0.184,419,0.623,32,0.674,7.2,294,67,226,0.228,570,0.516,39,0.554,7.6,2017-18
496,202344,Trevor Booker,1610612754,IND,67,36,31,1148.0,117,75,38,0.641,289,0.405,8,0.416,5.3,200,57,140,0.285,370,0.541,31,0.59,5.2,317,132,178,0.416,645,0.491,39,0.523,5.2,2017-18
497,203504,Trey Burke,1610612752,NYK,36,10,26,785.0,13,3,10,0.231,37,0.351,2,0.371,14.1,58,7,50,0.121,111,0.523,9,0.569,9.9,71,10,60,0.141,145,0.49,11,0.53,10.7,2017-18
498,1626168,Trey Lyles,1610612743,DEN,73,41,32,1391.0,55,42,12,0.764,177,0.311,2,0.314,6.4,292,78,212,0.267,468,0.624,31,0.668,4.6,347,120,224,0.346,617,0.562,33,0.594,4.9,2017-18
499,203590,Trey McKinney-Jones,1610612754,IND,1,1,0,1.0,0,0,0,0.0,0,0.0,0,0.0,0.0,0,0,0,0.0,0,0.0,0,0.0,0.0,0,0,0,0.0,0,0.0,0,0.0,0.0,2017-18
500,202684,Tristan Thompson,1610612739,CLE,53,27,26,1072.0,126,93,29,0.738,289,0.436,8,0.448,5.0,226,34,189,0.15,374,0.604,28,0.653,5.4,352,127,218,0.361,651,0.541,36,0.572,5.3,2017-18
501,203584,Troy Daniels,1610612756,PHX,79,20,59,1622.0,12,6,6,0.5,62,0.194,5,0.211,16.8,115,24,90,0.209,213,0.54,23,0.605,7.3,127,30,96,0.236,270,0.47,28,0.525,8.2,2017-18
502,1627786,Troy Williams,1610612752,NYK,21,7,14,307.0,22,10,12,0.455,56,0.393,1,0.4,6.8,41,8,32,0.195,61,0.672,3,0.707,5.6,63,18,44,0.286,113,0.558,4,0.578,6.0,2017-18
503,1628463,Tyler Cavanaugh,1610612737,ATL,38,11,27,503.0,44,31,12,0.705,114,0.386,2,0.393,4.9,80,20,60,0.25,143,0.559,8,0.593,4.9,124,51,72,0.411,246,0.504,10,0.525,4.9,2017-18
504,1628416,Tyler Dorsey,1610612737,ATL,56,15,41,974.0,17,4,13,0.235,92,0.185,6,0.198,13.3,113,13,99,0.115,202,0.559,19,0.617,7.2,130,17,112,0.131,290,0.448,25,0.491,8.0,2017-18
505,203898,Tyler Ennis,1610612747,LAL,54,22,32,683.0,19,6,12,0.316,68,0.279,3,0.292,8.2,76,10,66,0.132,123,0.618,6,0.65,7.9,95,16,78,0.168,186,0.511,9,0.537,7.9,2017-18
506,204020,Tyler Johnson,1610612748,MIA,71,38,33,2025.0,34,16,18,0.471,129,0.264,5,0.274,12.2,210,44,166,0.21,408,0.515,38,0.568,7.4,244,60,184,0.246,532,0.459,43,0.499,8.1,2017-18
507,1628399,Tyler Lydon,1610612743,DEN,1,1,0,2.0,0,0,0,0.0,0,0.0,0,0.0,0.0,0,0,0,0.0,0,0.0,0,0.0,0.0,0,0,0,0.0,0,0.0,0,0.0,0.0,2017-18
508,1627755,Tyler Ulis,1610612756,PHX,71,20,51,1658.0,24,3,21,0.125,112,0.214,1,0.216,17.6,104,11,94,0.106,190,0.547,19,0.608,11.3,128,14,115,0.109,299,0.428,20,0.459,12.5,2017-18
509,203092,Tyler Zeller,1610612749,MIL,64,26,38,1066.0,107,61,42,0.57,252,0.425,4,0.431,6.5,183,53,128,0.29,334,0.548,29,0.6,4.9,290,114,170,0.393,575,0.504,33,0.535,5.5,2017-18
510,201936,Tyreke Evans,1610612763,MEM,52,19,33,1607.0,44,30,14,0.682,213,0.207,10,0.217,6.8,221,43,176,0.195,380,0.582,23,0.619,7.6,265,73,190,0.275,578,0.458,33,0.486,7.5,2017-18
511,1627820,Tyrone Wallace,1610612746,LAC,30,17,13,851.0,21,10,10,0.476,92,0.228,4,0.239,12.3,84,14,71,0.167,140,0.6,12,0.656,8.6,105,24,81,0.229,221,0.475,16,0.512,9.3,2017-18
512,2199,Tyson Chandler,1610612756,PHX,46,15,31,1151.0,134,89,44,0.664,268,0.5,7,0.513,4.9,284,89,197,0.313,471,0.603,32,0.647,4.2,418,178,241,0.426,719,0.581,39,0.615,4.4,2017-18
513,1626145,Tyus Jones,1610612750,MIN,82,47,35,1467.0,16,3,13,0.188,63,0.254,1,0.258,17.4,116,14,101,0.121,206,0.563,21,0.627,9.6,132,17,114,0.129,267,0.494,22,0.539,10.5,2017-18
514,2617,Udonis Haslem,1610612748,MIA,14,9,5,72.0,3,1,1,0.333,4,0.75,0,0.75,8.4,7,1,6,0.143,15,0.467,2,0.538,5.0,10,2,7,0.2,18,0.556,2,0.625,5.8,2017-18
515,203505,Vander Blue,1610612747,LAL,5,1,4,45.0,0,0,0,0.0,1,0.0,0,0.0,0.0,1,0,1,0.0,1,1.0,1,0.0,7.2,1,0,1,0.0,2,0.5,1,1.0,7.2,2017-18
516,203506,Victor Oladipo,1610612754,IND,75,48,27,2552.0,47,26,21,0.553,234,0.201,11,0.211,11.1,343,77,269,0.224,624,0.55,48,0.595,6.7,390,103,290,0.264,850,0.459,59,0.493,7.2,2017-18
517,1713,Vince Carter,1610612758,SAC,58,20,38,1026.0,18,12,6,0.667,83,0.217,2,0.222,6.0,130,36,93,0.277,253,0.514,20,0.558,5.4,148,48,99,0.324,319,0.464,22,0.498,5.5,2017-18
518,1626205,Vincent Hunter,1610612763,MEM,4,0,4,7.0,2,2,0,1.0,2,1.0,0,1.0,2.9,1,1,0,1.0,2,0.5,0,0.5,5.7,3,3,0,1.0,4,0.75,0,0.75,3.9,2017-18
519,1627735,Wade Baldwin IV,1610612757,POR,7,4,3,80.0,1,0,1,0.0,3,0.333,0,0.333,28.9,7,0,7,0.0,11,0.636,1,0.7,7.6,8,0,8,0.0,14,0.571,1,0.615,10.3,2017-18
520,1627215,Walt Lemon Jr.,1610612740,NOP,5,4,1,35.0,0,0,0,0.0,1,0.0,0,0.0,0.0,2,0,1,0.0,1,2.0,0,2.0,13.5,2,0,1,0.0,2,1.0,0,1.0,13.5,2017-18
521,201961,Wayne Ellington,1610612748,MIA,76,41,35,2018.0,22,4,18,0.182,72,0.306,3,0.319,14.6,193,23,169,0.119,329,0.587,25,0.635,8.4,215,27,187,0.126,396,0.543,28,0.584,9.0,2017-18
522,1627782,Wayne Selden,1610612763,MEM,35,10,25,691.0,16,2,14,0.125,53,0.302,5,0.333,17.5,40,11,29,0.275,65,0.615,4,0.656,10.8,56,13,43,0.232,117,0.479,9,0.519,12.7,2017-18
523,1628411,Wes Iwundu,1610612753,ORL,62,18,44,1020.0,36,18,18,0.5,90,0.4,1,0.404,10.5,101,26,74,0.257,201,0.502,32,0.598,4.7,137,44,92,0.321,290,0.472,33,0.533,6.3,2017-18
524,202325,Wesley Johnson,1610612746,LAC,74,38,36,1486.0,29,9,19,0.31,77,0.377,4,0.397,14.3,187,43,143,0.23,346,0.54,24,0.581,7.2,216,52,162,0.241,407,0.531,28,0.57,8.1,2017-18
525,202083,Wesley Matthews,1610612742,DAL,63,20,43,2131.0,28,16,14,0.571,107,0.262,4,0.272,13.8,170,29,141,0.171,289,0.588,22,0.637,9.0,198,45,155,0.227,387,0.512,26,0.548,9.7,2017-18
526,203115,Will Barton,1610612743,DEN,81,46,35,2683.0,70,23,47,0.329,293,0.239,8,0.246,9.8,339,55,282,0.162,583,0.581,49,0.635,5.8,409,78,329,0.191,840,0.487,57,0.522,6.4,2017-18
527,1626161,Willie Cauley-Stein,1610612758,SAC,73,23,50,2044.0,131,82,50,0.626,355,0.369,6,0.375,6.6,379,101,278,0.266,645,0.588,34,0.62,4.7,510,183,328,0.359,954,0.535,40,0.558,5.2,2017-18
528,203186,Willie Reed,1610612746,LAC,42,20,22,428.0,35,24,10,0.686,118,0.297,2,0.302,5.4,86,27,59,0.314,167,0.515,12,0.555,4.8,121,51,69,0.421,274,0.442,14,0.465,5.0,2017-18
529,1626195,Willy Hernangomez,1610612766,CHA,48,20,28,494.0,61,47,14,0.77,151,0.404,1,0.407,6.4,122,38,81,0.311,194,0.629,21,0.705,4.1,183,85,95,0.464,325,0.563,22,0.604,4.9,2017-18
530,201163,Wilson Chandler,1610612743,DEN,74,41,33,2346.0,102,64,38,0.627,276,0.37,4,0.375,7.4,296,69,226,0.233,460,0.643,29,0.687,7.1,398,133,264,0.334,706,0.564,33,0.591,7.2,2017-18
531,204098,Xavier Munford,1610612749,MIL,6,2,4,21.0,1,0,1,0.0,1,1.0,0,1.0,21.5,0,0,0,0.0,0,0.0,0,0.0,0.0,1,0,1,0.0,1,1.0,0,1.0,21.5,2017-18
532,1628504,Xavier Rathan-Mayes,1610612752,NYK,5,0,5,118.0,0,0,0,0.0,2,0.0,0,0.0,0.0,5,0,5,0.0,10,0.5,0,0.5,10.0,5,0,5,0.0,12,0.417,0,0.417,10.0,2017-18
533,202918,Xavier Silas,1610612738,BOS,2,1,1,7.0,1,1,0,1.0,2,0.5,0,0.5,6.2,1,0,1,0.0,2,0.5,0,0.5,5.9,2,1,1,0.5,3,0.667,0,0.667,6.1,2017-18
534,1627812,Yogi Ferrell,1610612742,DAL,82,24,58,2282.0,26,5,22,0.192,141,0.184,5,0.191,14.7,223,39,182,0.175,438,0.509,41,0.562,8.1,249,44,204,0.177,566,0.44,46,0.479,8.8,2017-18
535,1628380,Zach Collins,1610612757,POR,66,41,25,1045.0,45,27,16,0.6,129,0.349,6,0.366,6.5,176,55,121,0.313,309,0.57,19,0.607,5.1,221,82,137,0.371,421,0.525,25,0.558,5.4,2017-18
536,203897,Zach LaVine,1610612741,CHI,24,9,15,656.0,9,4,5,0.444,63,0.143,1,0.145,5.5,85,16,70,0.188,129,0.659,7,0.697,6.7,94,20,75,0.213,186,0.505,8,0.528,6.5,2017-18
537,2216,Zach Randolph,1610612758,SAC,59,18,41,1508.0,97,74,20,0.763,261,0.372,3,0.376,5.4,300,81,218,0.27,474,0.633,35,0.683,4.3,397,155,238,0.39,720,0.551,38,0.582,4.6,2017-18
538,2585,Zaza Pachulia,1610612744,GSW,69,47,22,972.0,89,55,32,0.618,229,0.389,7,0.401,6.8,232,64,169,0.276,406,0.571,29,0.615,4.3,321,119,201,0.371,622,0.516,36,0.548,5.0,2017-18
539,1627753,Zhou Qi,1610612745,HOU,18,14,4,124.0,6,4,1,0.667,21,0.286,0,0.286,6.6,16,8,8,0.5,33,0.485,2,0.516,4.7,22,12,9,0.545,51,0.431,2,0.449,5.1,2017-18
0,203932,Aaron Gordon,1610612753,ORL,76,38,38,2567.0,128,76,50,0.594,269,0.476,11,0.496,7.2,439,113,318,0.257,620,0.708,42,0.76,6.3,567,189,368,0.333,860,0.659,53,0.703,6.5,2018-19
1,1628988,Aaron Holiday,1610612754,IND,50,31,19,646.0,5,2,3,0.4,18,0.278,0,0.278,16.0,62,5,57,0.081,98,0.633,12,0.721,9.0,67,7,60,0.104,115,0.583,12,0.65,9.5,2018-19
2,1627846,Abdel Nader,1610612760,OKC,60,37,23,686.0,14,3,11,0.214,44,0.318,0,0.318,16.8,100,21,79,0.21,158,0.633,10,0.676,7.3,114,24,90,0.211,191,0.597,10,0.63,8.5,2018-19
3,201143,Al Horford,1610612738,BOS,68,41,27,1973.0,120,59,60,0.492,264,0.455,4,0.462,8.2,338,117,219,0.346,607,0.557,55,0.612,5.8,458,176,279,0.384,853,0.537,59,0.577,6.4,2018-19
4,202329,Al-Farouq Aminu,1610612757,POR,81,52,29,2292.0,112,68,43,0.607,291,0.385,11,0.4,7.0,498,133,365,0.267,764,0.652,55,0.702,5.2,610,201,408,0.33,1011,0.603,66,0.646,5.6,2018-19
5,1626210,Alan Williams,1610612751,BKN,5,1,4,26.0,4,2,2,0.5,10,0.4,0,0.4,10.4,15,7,8,0.467,21,0.714,0,0.714,4.9,19,9,10,0.474,29,0.655,0,0.655,6.0,2018-19
6,202692,Alec Burks,1610612758,SAC,64,19,45,1375.0,30,16,14,0.533,101,0.297,2,0.303,9.0,205,44,161,0.215,322,0.637,33,0.709,5.2,235,60,175,0.255,405,0.58,35,0.635,5.6,2018-19
7,203518,Alex Abrines,1610612760,OKC,31,21,10,588.0,5,1,4,0.2,17,0.294,1,0.313,16.4,43,6,37,0.14,82,0.524,8,0.581,10.1,48,7,41,0.146,99,0.485,9,0.533,10.8,2018-19
8,1627936,Alex Caruso,1610612747,LAL,25,8,17,531.0,20,9,11,0.45,42,0.476,4,0.526,12.3,47,9,38,0.191,71,0.662,5,0.712,9.2,67,18,49,0.269,111,0.604,9,0.657,10.2,2018-19
9,203458,Alex Len,1610612737,ATL,77,28,49,1544.0,158,121,36,0.766,385,0.41,7,0.418,4.7,266,88,177,0.331,508,0.524,61,0.595,5.0,424,209,213,0.493,865,0.49,68,0.532,4.8,2018-19
10,1627816,Alex Poythress,1610612737,ATL,21,7,14,305.0,29,16,13,0.552,64,0.453,1,0.46,6.5,47,10,37,0.213,72,0.653,4,0.691,4.7,76,26,50,0.342,127,0.598,5,0.623,5.4,2018-19
11,1628035,Alfonzo McKinnie,1610612744,GSW,72,53,19,1003.0,81,57,26,0.704,177,0.458,4,0.468,5.6,166,40,123,0.241,253,0.656,23,0.722,4.8,247,97,149,0.393,411,0.601,27,0.643,5.1,2018-19
12,1628993,Alize Johnson,1610612754,IND,14,9,5,64.0,4,2,1,0.5,14,0.286,1,0.308,2.8,15,4,11,0.267,24,0.625,6,0.833,3.5,19,6,12,0.316,34,0.559,7,0.704,3.4,2018-19
13,203459,Allen Crabbe,1610612751,BKN,43,19,24,1133.0,16,6,11,0.375,48,0.333,2,0.348,11.6,132,29,102,0.22,207,0.638,18,0.698,7.1,148,35,113,0.236,249,0.594,20,0.646,7.7,2018-19
14,1629019,Allonzo Trier,1610612752,NYK,63,13,50,1435.0,31,11,19,0.355,109,0.284,5,0.298,13.1,164,17,145,0.104,276,0.594,29,0.664,8.1,195,28,164,0.144,374,0.521,34,0.574,8.9,2018-19
15,1628518,Amile Jefferson,1610612753,ORL,12,9,3,68.0,6,5,1,0.833,16,0.375,0,0.375,5.9,15,7,8,0.467,22,0.682,3,0.789,5.6,21,12,9,0.571,37,0.568,3,0.618,5.7,2018-19
16,101161,Amir Johnson,1610612755,PHI,51,32,19,529.0,47,36,9,0.766,116,0.405,5,0.423,4.9,100,50,50,0.5,176,0.568,21,0.645,4.0,147,86,59,0.585,281,0.523,26,0.576,4.2,2018-19
17,203083,Andre Drummond,1610612765,DET,79,40,39,2647.0,423,318,98,0.752,819,0.516,15,0.526,4.2,809,279,516,0.345,1175,0.689,70,0.732,3.9,1232,597,614,0.485,1921,0.641,85,0.671,4.0,2018-19
18,2738,Andre Iguodala,1610612744,GSW,68,47,21,1578.0,48,18,30,0.375,97,0.495,1,0.5,12.0,204,55,149,0.27,346,0.59,33,0.652,8.5,252,73,179,0.29,431,0.585,34,0.635,9.1,2018-19
19,201281,Andre Ingram,1610612747,LAL,4,1,3,15.0,1,1,0,1.0,1,1.0,0,1.0,2.6,1,0,1,0.0,2,0.5,0,0.5,7.8,2,1,1,0.5,3,0.667,0,0.667,5.2,2018-19
20,101106,Andrew Bogut,1610612744,GSW,11,8,3,134.0,12,6,2,0.5,25,0.48,0,0.48,1.9,43,9,34,0.209,67,0.642,7,0.717,3.5,55,15,36,0.273,90,0.611,7,0.663,3.3,2018-19
21,1626150,Andrew Harrison,1610612740,NOP,17,6,11,186.0,6,0,6,0.0,10,0.6,1,0.667,17.6,14,3,11,0.214,26,0.538,2,0.583,6.5,20,3,17,0.15,36,0.556,3,0.606,9.8,2018-19
22,203952,Andrew Wiggins,1610612750,MIN,73,31,42,2543.0,83,52,30,0.627,240,0.346,13,0.366,9.5,269,63,207,0.234,484,0.556,52,0.623,7.1,352,115,237,0.327,711,0.495,65,0.545,7.7,2018-19
23,1629014,Anfernee Simons,1610612757,POR,20,17,3,140.0,3,1,2,0.333,5,0.6,0,0.6,4.6,10,2,8,0.2,18,0.556,4,0.714,8.4,13,3,10,0.231,23,0.565,4,0.684,7.5,2018-19
24,1629116,Angel Delgado,1610612746,LAC,2,0,2,15.0,2,2,0,1.0,3,0.667,1,1.0,1.2,2,0,2,0.0,3,0.667,0,0.667,1.5,4,2,2,0.5,6,0.667,1,0.8,1.3,2018-19
25,1627790,Ante Zizic,1610612739,CLE,59,13,46,1082.0,108,66,41,0.611,283,0.382,9,0.394,3.7,212,80,131,0.377,382,0.555,40,0.62,5.0,320,146,172,0.456,652,0.491,49,0.531,4.6,2018-19
26,203076,Anthony Davis,1610612740,NOP,56,25,31,1850.0,174,125,49,0.718,337,0.516,6,0.526,5.4,498,182,314,0.365,731,0.681,44,0.725,4.7,672,307,363,0.457,1055,0.637,50,0.669,4.9,2018-19
27,201229,Anthony Tolliver,1610612750,MIN,65,27,38,1079.0,15,6,9,0.4,65,0.231,6,0.254,12.7,162,34,127,0.21,275,0.589,30,0.661,6.5,177,40,136,0.226,328,0.54,36,0.606,7.1,2018-19
28,1628469,Antonio Blakeney,1610612741,CHI,57,14,43,829.0,7,6,1,0.857,38,0.184,2,0.194,5.6,99,13,86,0.131,144,0.688,10,0.739,7.3,106,19,87,0.179,177,0.599,12,0.642,7.2,2018-19
29,203382,Aron Baynes,1610612738,BOS,51,32,19,821.0,88,67,21,0.761,200,0.44,5,0.451,4.5,152,52,99,0.342,298,0.51,34,0.576,4.8,240,119,120,0.496,489,0.491,39,0.533,4.7,2018-19
30,203085,Austin Rivers,1610612745,HOU,76,45,31,2028.0,25,12,14,0.48,66,0.379,2,0.391,9.9,137,27,109,0.197,300,0.457,35,0.517,7.7,162,39,123,0.241,364,0.445,37,0.495,8.1,2018-19
31,202340,Avery Bradley,1610612763,MEM,63,31,32,1905.0,43,20,23,0.465,121,0.355,8,0.381,11.5,132,17,114,0.129,265,0.498,32,0.567,9.2,175,37,137,0.211,383,0.457,40,0.51,9.8,2018-19
32,1629168,BJ Johnson,1610612758,SAC,7,2,5,49.0,2,2,0,1.0,3,0.667,0,0.667,4.1,6,0,6,0.0,10,0.6,0,0.6,5.0,8,2,6,0.25,13,0.615,0,0.615,4.8,2018-19
33,1628389,Bam Adebayo,1610612748,MIA,82,39,43,1913.0,165,114,51,0.691,397,0.416,7,0.423,6.3,432,136,295,0.315,709,0.609,53,0.659,5.5,597,250,346,0.419,1063,0.562,60,0.595,5.7,2018-19
34,203463,Ben McLemore,1610612758,SAC,19,7,12,158.0,3,2,1,0.667,12,0.25,2,0.3,11.0,14,1,13,0.071,23,0.609,6,0.824,8.8,17,3,14,0.176,35,0.486,8,0.63,9.2,2018-19
35,1627732,Ben Simmons,1610612755,PHI,78,50,28,2664.0,167,97,70,0.581,396,0.422,11,0.434,8.0,516,96,419,0.186,712,0.725,31,0.758,7.3,683,193,489,0.283,1062,0.643,42,0.67,7.4,2018-19
36,1628656,Billy Garrett,1610612752,NYK,4,1,3,63.0,0,0,0,0.0,2,0.0,0,0.0,0.0,3,0,3,0.0,5,0.6,1,0.75,6.4,3,0,3,0.0,6,0.5,1,0.6,6.4,2018-19
37,202687,Bismack Biyombo,1610612766,CHA,54,24,30,782.0,81,58,24,0.716,207,0.391,5,0.401,6.5,166,52,114,0.313,279,0.595,31,0.669,4.8,247,110,138,0.445,471,0.524,36,0.568,5.3,2018-19
38,201933,Blake Griffin,1610612765,DET,75,39,36,2622.0,100,67,30,0.67,283,0.353,9,0.365,7.9,465,141,320,0.303,714,0.651,60,0.711,5.2,565,208,350,0.368,949,0.595,69,0.642,5.7,2018-19
39,1626246,Boban Marjanovic,1610612755,PHI,58,31,27,681.0,87,72,13,0.828,181,0.481,7,0.5,3.7,178,75,104,0.421,297,0.599,26,0.657,4.1,265,147,117,0.555,468,0.566,33,0.609,4.0,2018-19
40,1626171,Bobby Portis,1610612764,WAS,49,14,35,1276.0,109,74,32,0.679,237,0.46,2,0.464,5.5,287,86,198,0.3,418,0.687,17,0.716,5.4,396,160,230,0.404,627,0.632,19,0.651,5.5,2018-19
41,203992,Bogdan Bogdanovic,1610612758,SAC,70,32,38,1947.0,40,25,16,0.625,117,0.342,7,0.364,8.6,203,40,164,0.197,350,0.58,34,0.642,8.1,243,65,180,0.267,455,0.534,41,0.587,8.2,2018-19
42,202711,Bojan Bogdanovic,1610612754,IND,81,47,34,2573.0,33,17,15,0.515,191,0.173,7,0.179,8.6,300,49,251,0.163,463,0.648,35,0.701,7.2,333,66,266,0.198,617,0.54,42,0.579,7.3,2018-19
43,1629045,Bonzie Colson,1610612749,MIL,8,6,2,98.0,8,7,1,0.875,20,0.4,1,0.421,6.3,22,4,18,0.182,32,0.688,1,0.71,4.9,30,11,19,0.367,49,0.612,2,0.638,5.3,2018-19
44,202954,Brad Wanamaker,1610612738,BOS,36,27,9,343.0,3,1,2,0.333,11,0.273,3,0.375,10.2,38,8,30,0.211,56,0.679,4,0.731,8.3,41,9,32,0.22,67,0.612,7,0.683,8.4,2018-19
45,203078,Bradley Beal,1610612764,WAS,81,31,50,2988.0,85,40,43,0.471,211,0.403,12,0.427,12.2,317,71,245,0.224,539,0.588,40,0.635,7.6,402,111,288,0.276,736,0.546,52,0.588,8.6,2018-19
46,1629164,Brandon Goodwin,1610612743,DEN,16,10,6,57.0,1,0,1,0.0,1,1.0,0,1.0,8.2,2,1,1,0.5,2,1.0,2,0.0,8.3,3,1,2,0.333,3,1.0,2,3.0,8.3,2018-19
47,1627742,Brandon Ingram,1610612747,LAL,52,25,27,1760.0,41,14,27,0.341,125,0.328,7,0.347,9.0,226,61,166,0.27,362,0.624,17,0.655,6.9,267,75,193,0.281,478,0.559,24,0.588,7.3,2018-19
48,202688,Brandon Knight,1610612739,CLE,39,17,22,737.0,10,6,4,0.6,33,0.303,4,0.345,9.9,49,9,40,0.184,83,0.59,10,0.671,7.6,59,15,44,0.254,116,0.509,14,0.578,8.0,2018-19
49,1629102,Brandon Sampson,1610612741,CHI,14,3,11,214.0,3,2,1,0.667,7,0.429,0,0.429,11.3,13,0,13,0.0,22,0.591,0,0.591,8.7,16,2,14,0.125,29,0.552,0,0.552,9.2,2018-19
50,201572,Brook Lopez,1610612749,MIL,81,60,21,2322.0,33,20,13,0.606,84,0.393,4,0.413,9.7,363,148,214,0.408,627,0.579,62,0.642,6.8,396,168,227,0.424,696,0.569,66,0.629,7.0,2018-19
51,1628971,Bruce Brown,1610612765,DET,74,35,39,1449.0,48,23,24,0.479,155,0.31,12,0.336,8.1,137,19,117,0.139,247,0.555,23,0.612,6.4,185,42,141,0.227,395,0.468,35,0.514,6.8,2018-19
52,203998,Bruno Caboclo,1610612763,MEM,34,14,20,800.0,42,22,20,0.524,114,0.368,3,0.378,8.3,116,34,82,0.293,187,0.62,12,0.663,6.0,158,56,102,0.354,292,0.541,15,0.57,6.6,2018-19
53,1627854,Bryn Forbes,1610612759,SAS,82,48,34,2293.0,18,4,14,0.222,75,0.24,6,0.261,18.4,221,32,188,0.145,396,0.558,38,0.617,7.7,239,36,202,0.151,465,0.514,44,0.568,8.5,2018-19
54,1627741,Buddy Hield,1610612758,SAC,82,39,43,2615.0,106,56,50,0.528,261,0.406,15,0.431,8.3,306,30,275,0.098,533,0.574,38,0.618,8.5,412,86,325,0.209,791,0.521,53,0.558,8.4,2018-19
55,203710,C.J. Williams,1610612750,MIN,15,4,11,128.0,1,0,1,0.0,3,0.333,0,0.333,23.0,7,0,7,0.0,14,0.5,2,0.583,7.2,8,0,8,0.0,17,0.471,2,0.533,9.2,2018-19
56,203468,CJ McCollum,1610612757,POR,70,43,27,2375.0,62,23,38,0.371,164,0.378,11,0.405,13.6,220,25,195,0.114,380,0.579,27,0.623,8.3,282,48,233,0.17,535,0.527,38,0.567,9.5,2018-19
57,101139,CJ Miles,1610612763,MEM,53,33,20,857.0,13,8,5,0.615,34,0.382,1,0.394,15.4,82,18,62,0.22,129,0.636,10,0.689,8.3,95,26,67,0.274,160,0.594,11,0.638,9.3,2018-19
58,1628403,Caleb Swanigan,1610612758,SAC,21,10,11,178.0,17,11,6,0.647,52,0.327,2,0.34,6.4,47,18,28,0.383,69,0.681,5,0.734,4.3,64,29,34,0.453,117,0.547,7,0.582,4.8,2018-19
59,1626166,Cameron Payne,1610612739,CLE,40,7,33,712.0,13,4,8,0.308,29,0.448,0,0.448,13.6,59,1,58,0.017,100,0.59,11,0.663,9.1,72,5,66,0.069,129,0.558,11,0.61,9.8,2018-19
60,1629244,Cameron Reynolds,1610612750,MIN,19,6,13,259.0,4,2,2,0.5,13,0.308,0,0.308,15.1,27,5,22,0.185,41,0.659,2,0.692,8.8,31,7,24,0.226,53,0.585,2,0.608,9.6,2018-19
61,1627747,Caris LeVert,1610612751,BKN,40,19,21,1063.0,35,16,18,0.457,91,0.385,7,0.417,9.4,116,22,94,0.19,190,0.611,17,0.671,7.8,151,38,112,0.252,280,0.539,24,0.59,8.2,2018-19
62,2546,Carmelo Anthony,1610612745,HOU,10,4,6,294.0,9,6,3,0.667,23,0.391,0,0.391,8.9,45,15,30,0.333,76,0.592,7,0.652,5.0,54,21,33,0.389,94,0.574,7,0.621,5.6,2018-19
63,1626224,Cedi Osman,1610612739,CLE,76,17,59,2444.0,45,11,35,0.244,153,0.294,6,0.306,12.8,312,50,259,0.16,491,0.635,50,0.707,6.6,357,61,294,0.171,615,0.58,56,0.639,7.4,2018-19
64,1628990,Chandler Hutchison,1610612741,CHI,44,10,34,895.0,31,13,18,0.419,69,0.449,3,0.47,10.3,154,31,123,0.201,257,0.599,15,0.636,5.8,185,44,141,0.238,313,0.591,18,0.627,6.6,2018-19
65,202718,Chandler Parsons,1610612763,MEM,25,11,14,496.0,4,2,2,0.5,22,0.182,1,0.19,8.0,66,3,62,0.045,107,0.617,6,0.653,7.5,70,5,64,0.071,125,0.56,7,0.593,7.5,2018-19
66,101112,Channing Frye,1610612739,CLE,36,7,29,341.0,4,1,3,0.25,13,0.308,0,0.308,17.2,48,13,34,0.271,70,0.686,7,0.762,6.0,52,14,37,0.269,80,0.65,7,0.712,6.9,2018-19
67,1626184,Chasson Randle,1610612764,WAS,48,18,30,720.0,10,4,6,0.4,23,0.435,3,0.5,11.0,44,5,39,0.114,79,0.557,10,0.638,9.5,54,9,45,0.167,102,0.529,13,0.607,9.8,2018-19
68,1627767,Cheick Diallo,1610612740,NOP,64,27,37,896.0,75,41,35,0.547,187,0.401,8,0.419,6.3,257,81,174,0.315,401,0.641,36,0.704,4.5,332,122,209,0.367,564,0.589,44,0.638,4.9,2018-19
69,1629002,Chimezie Metu,1610612759,SAS,29,14,15,145.0,9,6,3,0.667,15,0.6,2,0.692,5.4,27,5,22,0.185,39,0.692,4,0.771,5.6,36,11,25,0.306,53,0.679,6,0.766,5.6,2018-19
70,1628449,Chris Boucher,1610612761,TOR,28,21,7,163.0,16,9,7,0.563,44,0.364,1,0.372,5.4,40,15,25,0.375,59,0.678,2,0.702,5.0,56,24,32,0.429,95,0.589,3,0.609,5.1,2018-19
71,1629185,Chris Chiozza,1610612745,HOU,7,6,1,33.0,1,0,1,0.0,3,0.333,0,0.333,20.4,3,0,3,0.0,5,0.6,2,1.0,8.2,4,0,4,0.0,8,0.5,2,0.667,11.2,2018-19
72,101108,Chris Paul,1610612745,HOU,58,39,19,1857.0,36,17,19,0.472,91,0.396,3,0.409,14.0,229,37,192,0.162,427,0.536,43,0.596,7.9,265,54,211,0.204,517,0.513,46,0.563,8.8,2018-19
73,1626174,Christian Wood,1610612740,NOP,21,13,8,250.0,17,14,3,0.824,45,0.378,1,0.386,4.7,66,20,45,0.303,102,0.647,3,0.667,4.0,83,34,48,0.41,141,0.589,4,0.606,4.2,2018-19
74,203991,Clint Capela,1610612745,HOU,67,44,23,2249.0,298,202,93,0.678,581,0.513,8,0.52,6.2,550,174,371,0.316,836,0.658,64,0.712,4.7,848,376,464,0.443,1390,0.61,72,0.643,5.3,2018-19
75,203469,Cody Zeller,1610612766,CHA,49,22,27,1243.0,110,81,29,0.736,328,0.335,11,0.347,4.4,223,62,157,0.278,422,0.528,49,0.598,5.8,333,143,186,0.429,742,0.449,60,0.488,5.3,2018-19
76,1629012,Collin Sexton,1610612739,CLE,82,19,63,2605.0,57,25,33,0.439,203,0.281,17,0.306,10.2,179,30,149,0.168,338,0.53,51,0.624,10.0,236,55,182,0.233,541,0.436,68,0.499,10.0,2018-19
77,201147,Corey Brewer,1610612758,SAC,31,13,18,492.0,26,13,13,0.5,51,0.51,0,0.51,7.2,50,9,41,0.18,80,0.625,10,0.714,7.7,76,22,54,0.289,126,0.603,10,0.655,7.5,2018-19
78,202709,Cory Joseph,1610612754,IND,82,48,34,2063.0,39,13,25,0.333,114,0.342,7,0.364,11.2,240,37,204,0.154,410,0.585,38,0.645,8.7,279,50,229,0.179,513,0.544,45,0.596,9.1,2018-19
79,201584,Courtney Lee,1610612742,DAL,34,6,28,428.0,9,4,5,0.444,20,0.45,1,0.474,15.3,45,7,38,0.156,68,0.662,4,0.703,8.1,54,11,43,0.204,87,0.621,5,0.659,9.3,2018-19
80,1626245,Cristiano Felicio,1610612741,CHI,60,16,44,746.0,79,52,27,0.658,181,0.436,7,0.454,4.7,139,44,95,0.317,230,0.604,21,0.665,3.9,218,96,122,0.44,401,0.544,28,0.584,4.2,2018-19
81,1626156,D'Angelo Russell,1610612751,BKN,81,42,39,2448.0,53,20,33,0.377,149,0.356,10,0.381,12.7,262,33,229,0.126,427,0.614,30,0.66,7.7,315,53,262,0.168,574,0.549,40,0.59,8.6,2018-19
82,201571,D.J. Augustin,1610612753,ORL,79,40,39,2202.0,41,13,28,0.317,114,0.36,7,0.383,12.2,153,12,141,0.078,232,0.659,23,0.732,11.1,194,25,169,0.129,343,0.566,30,0.62,11.4,2018-19
83,1628391,D.J. Wilson,1610612749,MIL,48,37,11,882.0,45,25,19,0.556,127,0.354,5,0.369,4.5,177,43,133,0.243,290,0.61,36,0.697,5.3,222,68,152,0.306,401,0.554,41,0.617,5.1,2018-19
84,203474,DJ Stephens,1610612763,MEM,1,0,1,7.0,0,0,0,0.0,0,0.0,0,0.0,0.0,0,0,0,0.0,0,0.0,0,0.0,0.0,0,0,0,0.0,0,0.0,0,0.0,0.0,2018-19
85,1629541,Dairis Bertans,1610612740,NOP,12,3,9,167.0,2,0,2,0.0,3,0.667,0,0.667,35.8,7,2,5,0.286,13,0.538,3,0.7,11.8,9,2,7,0.222,16,0.563,3,0.692,17.2,2018-19
86,1627745,Damian Jones,1610612744,GSW,24,15,9,410.0,31,14,16,0.452,72,0.431,1,0.437,6.5,44,10,34,0.227,100,0.44,13,0.506,6.2,75,24,50,0.32,172,0.436,14,0.475,6.4,2018-19
87,203081,Damian Lillard,1610612757,POR,80,51,29,2838.0,68,25,42,0.368,218,0.312,19,0.342,13.4,303,42,261,0.139,475,0.638,35,0.689,8.4,371,67,303,0.181,687,0.54,54,0.586,9.3,2018-19
88,1627814,Damion Lee,1610612744,GSW,32,18,14,375.0,8,3,5,0.375,27,0.296,3,0.333,12.8,56,7,49,0.125,87,0.644,7,0.7,7.1,64,10,54,0.156,111,0.577,10,0.634,7.8,2018-19
89,1628422,Damyean Dotson,1610612752,NYK,72,12,60,1978.0,34,10,22,0.294,82,0.415,1,0.42,12.9,225,34,192,0.151,350,0.643,29,0.701,8.4,259,44,214,0.17,419,0.618,30,0.666,9.0,2018-19
90,1627772,Daniel Hamilton,1610612737,ATL,19,7,12,204.0,10,6,3,0.6,22,0.455,0,0.455,4.5,37,9,28,0.243,62,0.597,6,0.661,5.1,47,15,31,0.319,82,0.573,6,0.618,5.0,2018-19
91,1628464,Daniel Theis,1610612738,BOS,66,38,28,908.0,87,55,31,0.632,195,0.446,5,0.458,6.8,138,55,83,0.399,273,0.505,39,0.59,4.9,225,110,114,0.489,456,0.493,44,0.546,5.7,2018-19
92,201568,Danilo Gallinari,1610612746,LAC,68,40,28,2059.0,54,31,23,0.574,150,0.36,6,0.375,8.6,363,62,301,0.171,579,0.627,49,0.685,5.4,417,93,324,0.223,711,0.586,55,0.636,5.8,2018-19
93,201980,Danny Green,1610612761,TOR,80,56,24,2215.0,60,29,31,0.483,132,0.455,5,0.472,11.6,257,57,200,0.222,451,0.57,33,0.615,6.4,317,86,231,0.271,580,0.547,38,0.585,7.4,2018-19
94,201967,Dante Cunningham,1610612759,SAS,64,36,28,928.0,48,28,20,0.583,111,0.432,1,0.436,8.1,140,26,112,0.186,225,0.622,23,0.693,6.0,188,54,132,0.287,324,0.58,24,0.627,6.6,2018-19
95,203957,Dante Exum,1610612762,UTA,41,21,20,648.0,16,5,11,0.313,33,0.485,1,0.5,11.7,50,9,41,0.18,87,0.575,9,0.641,8.6,66,14,52,0.212,116,0.569,10,0.623,9.4,2018-19
96,1627863,Danuel House Jr.,1610612745,HOU,39,27,12,979.0,25,12,13,0.48,58,0.431,1,0.439,11.1,115,20,95,0.174,206,0.558,18,0.612,7.6,140,32,108,0.229,264,0.53,19,0.571,8.2,2018-19
97,203967,Dario Saric,1610612750,MIN,81,39,42,2022.0,126,86,40,0.683,356,0.354,14,0.368,7.0,331,107,224,0.323,594,0.557,50,0.608,5.5,457,193,264,0.422,921,0.496,64,0.533,5.9,2018-19
98,203121,Darius Miller,1610612740,NOP,69,31,38,1757.0,14,3,10,0.214,44,0.318,7,0.378,20.3,114,30,83,0.263,194,0.588,19,0.651,9.9,128,33,93,0.258,234,0.547,26,0.615,11.0,2018-19
99,201954,Darren Collison,1610612754,IND,76,45,31,2143.0,36,7,29,0.194,112,0.321,6,0.34,17.5,196,13,182,0.066,340,0.576,30,0.632,9.8,232,20,211,0.086,450,0.516,36,0.56,11.0,2018-19
100,1629133,Daryl Macon,1610612742,DAL,8,4,4,90.0,2,0,2,0.0,6,0.333,1,0.4,18.7,10,2,8,0.2,19,0.526,1,0.556,5.9,12,2,10,0.167,25,0.48,2,0.522,8.0,2018-19
101,1628021,David Nwaba,1610612739,CLE,51,14,37,984.0,41,23,18,0.561,107,0.383,6,0.406,8.1,122,29,92,0.238,209,0.584,20,0.646,6.4,163,52,110,0.319,309,0.528,26,0.576,6.9,2018-19
102,202722,Davis Bertans,1610612759,SAS,76,44,32,1632.0,23,8,15,0.348,65,0.354,1,0.359,9.4,241,57,179,0.237,408,0.591,36,0.648,6.4,264,65,194,0.246,451,0.585,37,0.638,6.6,2018-19
103,1628432,Davon Reed,1610612754,IND,10,4,6,47.0,2,1,1,0.5,5,0.4,0,0.4,3.9,4,2,2,0.5,5,0.8,1,1.0,7.1,6,3,3,0.5,10,0.6,1,0.667,6.1,2018-19
104,1628368,De'Aaron Fox,1610612758,SAC,81,39,42,2546.0,43,12,29,0.279,152,0.283,14,0.312,12.6,261,41,218,0.157,459,0.569,46,0.632,8.7,304,53,247,0.174,608,0.5,60,0.555,9.2,2018-19
105,1629001,De'Anthony Melton,1610612756,PHX,50,13,37,984.0,25,16,9,0.64,66,0.379,4,0.403,7.4,109,29,80,0.266,203,0.537,20,0.596,6.7,134,45,89,0.336,263,0.51,24,0.561,6.9,2018-19
106,201599,DeAndre Jordan,1610612752,NYK,69,25,44,2047.0,225,136,87,0.604,510,0.441,8,0.448,5.6,677,185,491,0.273,935,0.724,51,0.766,4.2,902,321,578,0.356,1402,0.643,59,0.672,4.6,2018-19
107,1627761,DeAndre' Bembry,1610612737,ATL,82,29,53,1931.0,54,27,25,0.5,168,0.321,5,0.331,10.3,304,65,241,0.214,483,0.629,32,0.674,7.6,358,92,266,0.257,633,0.566,37,0.601,8.0,2018-19
108,201942,DeMar DeRozan,1610612759,SAS,77,44,33,2688.0,54,25,27,0.463,207,0.261,10,0.274,11.1,408,63,333,0.154,636,0.642,52,0.699,6.9,462,88,360,0.19,810,0.57,62,0.618,7.4,2018-19
109,202326,DeMarcus Cousins,1610612744,GSW,30,23,7,771.0,43,26,17,0.605,117,0.368,2,0.374,4.6,204,58,146,0.284,315,0.648,20,0.692,4.5,247,84,163,0.34,417,0.592,22,0.625,4.5,2018-19
110,201960,DeMarre Carroll,1610612751,BKN,67,36,31,1703.0,68,27,40,0.397,188,0.362,6,0.374,9.5,281,49,229,0.174,492,0.571,51,0.637,6.3,349,76,269,0.218,662,0.527,57,0.577,6.9,2018-19
111,1629152,DeVaughn Akoon-Purcell,1610612743,DEN,7,7,0,22.0,1,0,1,0.0,3,0.333,0,0.333,26.3,3,0,3,0.0,6,0.5,2,0.75,11.8,4,0,4,0.0,9,0.444,2,0.571,15.4,2018-19
112,1629028,Deandre Ayton,1610612756,PHX,71,17,54,2183.0,223,156,66,0.7,479,0.466,12,0.478,5.5,506,163,341,0.322,785,0.645,59,0.697,4.4,729,319,407,0.438,1212,0.601,71,0.639,4.8,2018-19
113,1626153,Delon Wright,1610612763,MEM,75,45,30,1698.0,68,31,38,0.456,170,0.4,4,0.41,8.5,198,35,163,0.177,337,0.588,40,0.667,7.3,266,66,201,0.248,491,0.542,44,0.595,7.6,2018-19
114,1627743,Demetrius Jackson,1610612755,PHI,6,5,1,39.0,2,0,2,0.0,3,0.667,0,0.667,12.0,1,0,1,0.0,1,1.0,0,1.0,2.8,3,0,3,0.0,4,0.75,0,0.75,8.9,2018-19
115,1629061,Deng Adel,1610612739,CLE,19,4,15,194.0,3,1,2,0.333,9,0.333,0,0.333,14.3,16,3,13,0.188,34,0.471,5,0.552,7.9,19,4,15,0.211,43,0.442,5,0.5,8.9,2018-19
116,203471,Dennis Schroder,1610612760,OKC,78,46,32,2288.0,38,6,32,0.158,144,0.264,9,0.281,16.9,242,19,222,0.079,372,0.651,20,0.688,9.2,280,25,254,0.089,512,0.547,29,0.58,10.3,2018-19
117,1628372,Dennis Smith Jr.,1610612752,NYK,53,21,32,1508.0,32,14,18,0.438,116,0.276,11,0.305,12.1,123,19,104,0.154,255,0.482,37,0.564,7.6,155,33,122,0.213,369,0.42,48,0.483,8.6,2018-19
118,1629126,Deonte Burton,1610612760,OKC,32,21,11,240.0,4,1,3,0.25,20,0.2,1,0.211,8.1,24,10,14,0.417,55,0.436,12,0.558,7.8,28,11,17,0.393,75,0.373,13,0.452,7.9,2018-19
119,202324,Derrick Favors,1610612762,UTA,75,46,29,1742.0,203,145,56,0.714,399,0.509,5,0.515,4.5,349,125,225,0.358,600,0.582,64,0.651,4.7,552,270,281,0.489,968,0.57,69,0.614,4.6,2018-19
120,1627884,Derrick Jones Jr.,1610612748,MIA,60,31,29,1154.0,96,59,39,0.615,199,0.482,6,0.497,6.4,144,44,99,0.306,253,0.569,24,0.629,6.8,240,103,138,0.429,434,0.553,30,0.594,6.7,2018-19
121,201565,Derrick Rose,1610612750,MIN,51,24,27,1392.0,33,12,21,0.364,105,0.314,6,0.333,12.5,107,11,95,0.103,221,0.484,23,0.54,9.5,140,23,116,0.164,324,0.432,29,0.475,10.2,2018-19
122,1628401,Derrick White,1610612759,SAS,67,41,26,1728.0,35,13,20,0.371,95,0.368,4,0.385,10.6,212,28,180,0.132,357,0.594,34,0.656,6.9,247,41,200,0.166,450,0.549,38,0.6,7.4,2018-19
123,1626164,Devin Booker,1610612756,PHX,64,15,49,2242.0,39,18,22,0.462,129,0.302,3,0.31,12.3,226,26,199,0.115,375,0.603,23,0.642,8.7,265,44,221,0.166,494,0.536,26,0.566,9.2,2018-19
124,2734,Devin Harris,1610612742,DAL,68,28,40,1071.0,12,5,7,0.417,38,0.316,2,0.333,16.7,100,16,84,0.16,163,0.613,12,0.662,9.1,112,21,91,0.188,197,0.569,14,0.612,9.9,2018-19
125,1628421,Devin Robinson,1610612764,WAS,7,1,6,95.0,6,4,2,0.667,10,0.6,0,0.6,6.3,14,4,10,0.286,28,0.5,0,0.5,5.1,20,8,12,0.4,37,0.541,0,0.541,5.5,2018-19
126,1628984,Devonte' Graham,1610612766,CHA,46,18,28,676.0,10,5,5,0.5,34,0.294,3,0.323,13.6,53,12,41,0.226,96,0.552,13,0.639,7.7,63,17,46,0.27,127,0.496,16,0.568,8.6,2018-19
127,203473,Dewayne Dedmon,1610612737,ATL,64,24,40,1609.0,105,70,35,0.667,263,0.399,8,0.412,6.1,375,125,250,0.333,597,0.628,41,0.674,4.9,480,195,285,0.406,820,0.585,49,0.623,5.2,2018-19
128,1627738,Deyonta Davis,1610612737,ATL,9,3,6,118.0,10,7,2,0.7,32,0.313,1,0.323,3.5,26,9,17,0.346,40,0.65,4,0.722,6.2,36,16,19,0.444,66,0.545,5,0.59,5.5,2018-19
129,1628415,Dillon Brooks,1610612763,MEM,18,9,9,330.0,9,4,5,0.444,20,0.45,0,0.45,5.6,22,6,16,0.273,39,0.564,8,0.71,5.8,31,10,21,0.323,57,0.544,8,0.633,5.8,2018-19
130,203079,Dion Waiters,1610612748,MIA,44,20,24,1138.0,7,3,5,0.429,37,0.189,1,0.194,15.9,109,16,93,0.147,191,0.571,20,0.637,9.6,116,19,98,0.164,228,0.509,21,0.56,10.0,2018-19
131,1717,Dirk Nowitzki,1610612742,DAL,51,17,34,795.0,5,2,3,0.4,29,0.172,3,0.192,6.0,153,46,107,0.301,261,0.586,25,0.648,4.6,158,48,110,0.304,279,0.566,28,0.629,4.7,2018-19
132,1627734,Domantas Sabonis,1610612754,IND,74,43,31,1838.0,186,136,51,0.731,436,0.427,13,0.44,4.7,504,153,351,0.304,819,0.615,79,0.681,3.9,690,289,402,0.419,1211,0.57,92,0.617,4.1,2018-19
133,202700,Donatas Motiejunas,1610612759,SAS,3,3,0,13.0,2,1,1,0.5,3,0.667,0,0.667,7.7,1,0,1,0.0,3,0.333,0,0.333,2.5,3,1,2,0.333,6,0.5,0,0.5,5.9,2018-19
134,1628378,Donovan Mitchell,1610612762,UTA,76,49,27,2564.0,59,28,31,0.475,180,0.328,13,0.353,9.4,256,44,211,0.172,394,0.65,23,0.69,9.2,315,72,242,0.229,564,0.559,36,0.597,9.2,2018-19
135,1628978,Donte DiVincenzo,1610612749,MIL,27,20,7,411.0,16,12,4,0.75,35,0.457,1,0.471,8.0,49,7,42,0.143,85,0.576,10,0.653,7.7,65,19,46,0.292,120,0.542,11,0.596,7.7,2018-19
136,1629055,Donte Grantham,1610612760,OKC,3,2,1,2.0,0,0,0,0.0,0,0.0,0,0.0,0.0,0,0,0,0.0,0,0.0,0,0.0,0.0,0,0,0,0.0,0,0.0,0,0.0,0.0,2018-19
137,1627827,Dorian Finney-Smith,1610612742,DAL,81,33,48,1985.0,138,93,42,0.674,303,0.455,10,0.471,6.5,251,71,180,0.283,467,0.537,64,0.623,5.9,389,164,222,0.422,748,0.52,74,0.577,6.1,2018-19
138,203926,Doug McDermott,1610612754,IND,77,43,34,1340.0,17,9,8,0.529,44,0.386,1,0.395,16.0,92,25,66,0.272,171,0.538,18,0.601,7.0,109,34,74,0.312,208,0.524,19,0.577,8.4,2018-19
139,1627733,Dragan Bender,1610612756,PHX,46,9,37,826.0,34,21,13,0.618,92,0.37,0,0.37,6.4,149,48,101,0.322,269,0.554,24,0.608,4.2,183,69,114,0.377,338,0.541,24,0.583,4.6,2018-19
140,203110,Draymond Green,1610612744,GSW,66,48,18,2065.0,60,31,29,0.517,184,0.326,7,0.339,8.4,421,140,279,0.333,692,0.608,50,0.656,5.0,481,171,308,0.356,830,0.58,57,0.622,5.4,2018-19
141,1629234,Drew Eubanks,1610612759,SAS,23,13,10,113.0,6,4,2,0.667,16,0.375,0,0.375,3.9,28,11,17,0.393,39,0.718,3,0.778,4.2,34,15,19,0.441,51,0.667,3,0.708,4.1,2018-19
142,1629130,Duncan Robinson,1610612748,MIA,15,7,8,161.0,2,1,2,0.5,7,0.286,0,0.286,14.7,17,2,15,0.118,32,0.531,6,0.654,8.2,19,3,17,0.158,38,0.5,6,0.594,9.0,2018-19
143,1628605,Dusty Hannahs,1610612763,MEM,2,0,2,26.0,0,0,0,0.0,1,0.0,0,0.0,0.0,1,0,1,0.0,1,1.0,0,1.0,6.2,1,0,1,0.0,2,0.5,0,0.5,6.2,2018-19
144,1628407,Dwayne Bacon,1610612766,CHA,43,20,23,759.0,8,2,6,0.25,37,0.216,1,0.222,16.0,81,24,57,0.296,136,0.596,15,0.669,6.8,89,26,63,0.292,170,0.524,16,0.578,7.6,2018-19
145,2730,Dwight Howard,1610612764,WAS,9,4,5,230.0,24,17,7,0.708,57,0.421,0,0.421,3.0,59,17,42,0.288,97,0.608,8,0.663,4.0,83,34,49,0.41,149,0.557,8,0.589,3.7,2018-19
146,203939,Dwight Powell,1610612742,DAL,77,31,46,1663.0,140,76,64,0.543,363,0.386,6,0.392,7.4,271,65,206,0.24,453,0.598,39,0.655,6.1,411,141,270,0.343,792,0.519,45,0.55,6.5,2018-19
147,2548,Dwyane Wade,1610612748,MIA,72,35,37,1885.0,69,38,30,0.551,137,0.504,15,0.566,8.4,216,30,186,0.139,359,0.602,42,0.681,7.5,285,68,216,0.239,488,0.584,57,0.661,7.7,2018-19
148,1629058,Dzanan Musa,1610612751,BKN,9,4,5,39.0,1,0,1,0.0,3,0.333,0,0.333,16.4,4,3,1,0.75,5,0.8,0,0.8,3.8,5,3,2,0.6,8,0.625,0,0.625,6.3,2018-19
149,202734,E'Twaun Moore,1610612740,NOP,53,21,32,1463.0,35,19,15,0.543,88,0.398,3,0.412,11.1,92,20,73,0.217,150,0.613,6,0.639,10.9,127,39,88,0.307,234,0.543,9,0.564,10.9,2018-19
150,202334,Ed Davis,1610612751,BKN,81,42,39,1446.0,216,148,66,0.685,485,0.445,10,0.455,5.1,478,145,335,0.303,734,0.651,50,0.699,4.3,694,293,401,0.422,1184,0.586,60,0.617,4.6,2018-19
151,1628410,Edmond Sumner,1610612754,IND,23,14,9,210.0,9,8,1,0.889,20,0.45,0,0.45,5.4,15,1,14,0.067,25,0.6,5,0.75,10.3,24,9,15,0.375,45,0.533,5,0.6,8.5,2018-19
152,202327,Ekpe Udoh,1610612762,UTA,51,35,16,320.0,27,19,8,0.704,68,0.397,4,0.422,4.6,63,18,46,0.286,108,0.583,9,0.636,5.4,90,37,54,0.411,173,0.52,13,0.563,5.1,2018-19
153,203901,Elfrid Payton,1610612740,NOP,42,18,24,1250.0,49,21,26,0.429,131,0.374,8,0.398,10.3,171,24,148,0.14,275,0.622,22,0.676,7.9,220,45,174,0.205,399,0.551,30,0.596,8.5,2018-19
154,1629059,Elie Okobo,1610612756,PHX,53,7,46,958.0,12,3,9,0.25,36,0.333,2,0.353,18.4,86,11,76,0.128,147,0.585,6,0.61,9.2,98,14,85,0.143,181,0.541,8,0.566,10.3,2018-19
155,1629150,Emanuel Terry,1610612748,MIA,3,0,3,23.0,3,3,0,1.0,5,0.6,0,0.6,4.7,4,2,2,0.5,8,0.5,1,0.571,3.9,7,5,2,0.714,13,0.538,1,0.583,4.2,2018-19
156,1626144,Emmanuel Mudiay,1610612752,NYK,58,13,45,1576.0,32,16,15,0.5,128,0.25,12,0.276,10.7,157,17,140,0.108,269,0.584,30,0.657,9.5,189,33,155,0.175,387,0.488,42,0.548,9.7,2018-19
157,202683,Enes Kanter,1610612757,POR,67,28,39,1639.0,257,214,43,0.833,611,0.421,14,0.43,3.9,402,124,278,0.308,678,0.593,61,0.652,4.2,659,338,321,0.513,1260,0.523,75,0.556,4.1,2018-19
158,202339,Eric Bledsoe,1610612749,MIL,78,59,19,2272.0,82,54,27,0.659,198,0.414,3,0.421,9.1,280,29,251,0.104,457,0.613,38,0.668,9.3,362,83,278,0.229,646,0.56,41,0.598,9.3,2018-19
159,201569,Eric Gordon,1610612745,HOU,68,44,24,2158.0,17,3,13,0.176,88,0.193,5,0.205,18.3,131,22,105,0.168,238,0.55,19,0.598,9.2,148,25,118,0.169,321,0.461,24,0.498,10.2,2018-19
160,203961,Eric Moreland,1610612761,TOR,5,3,2,43.0,4,4,0,1.0,8,0.5,0,0.5,5.6,16,3,13,0.188,23,0.696,3,0.8,4.0,20,7,13,0.35,31,0.645,3,0.714,4.3,2018-19
161,101141,Ersan Ilyasova,1610612749,MIL,67,49,18,1231.0,94,68,25,0.723,226,0.416,6,0.427,5.6,208,64,143,0.308,351,0.593,32,0.652,5.3,302,132,168,0.437,557,0.542,38,0.582,5.4,2018-19
162,203095,Evan Fournier,1610612753,ORL,79,40,39,2490.0,35,13,21,0.371,109,0.321,5,0.337,12.4,213,43,168,0.202,367,0.58,37,0.645,8.8,248,56,189,0.226,473,0.524,42,0.575,9.3,2018-19
163,202323,Evan Turner,1610612757,POR,73,47,26,1606.0,37,17,20,0.459,127,0.291,8,0.311,9.7,291,45,246,0.155,471,0.618,38,0.672,5.4,328,62,266,0.189,570,0.575,46,0.626,5.9,2018-19
164,1628402,Frank Jackson,1610612740,NOP,61,22,39,1169.0,25,12,12,0.48,76,0.329,4,0.347,9.7,109,19,90,0.174,191,0.571,20,0.637,7.6,134,31,102,0.231,265,0.506,24,0.556,8.0,2018-19
165,1626163,Frank Kaminsky,1610612766,CHA,47,22,25,755.0,39,23,16,0.59,96,0.406,1,0.411,6.5,124,47,77,0.379,236,0.525,27,0.593,4.9,163,70,93,0.429,321,0.508,28,0.556,5.2,2018-19
166,1628412,Frank Mason,1610612758,SAC,38,16,22,435.0,6,2,4,0.333,21,0.286,3,0.333,11.9,37,5,32,0.135,56,0.661,4,0.712,8.9,43,7,36,0.163,76,0.566,7,0.623,9.3,2018-19
167,1628373,Frank Ntilikina,1610612752,NYK,42,9,33,887.0,12,3,9,0.25,46,0.261,2,0.273,17.9,72,7,65,0.097,133,0.541,12,0.595,10.6,84,10,74,0.119,169,0.497,14,0.542,11.6,2018-19
168,1627832,Fred VanVleet,1610612761,TOR,64,46,18,1760.0,21,5,16,0.238,70,0.3,1,0.304,16.6,146,22,124,0.151,245,0.596,26,0.667,9.8,167,27,140,0.162,313,0.534,27,0.584,10.6,2018-19
169,1627788,Furkan Korkmaz,1610612755,PHI,48,30,18,679.0,16,4,12,0.25,47,0.34,2,0.356,11.4,91,12,79,0.132,137,0.664,8,0.705,7.0,107,16,91,0.15,173,0.618,10,0.656,7.6,2018-19
170,202066,Garrett Temple,1610612746,LAC,75,37,38,2041.0,28,10,18,0.357,97,0.289,8,0.315,12.7,188,43,146,0.229,322,0.584,29,0.642,8.7,216,53,164,0.245,399,0.541,37,0.597,9.2,2018-19
171,1629109,Gary Clark,1610612745,HOU,51,33,18,641.0,24,10,14,0.417,57,0.421,2,0.436,11.8,92,27,65,0.293,163,0.564,12,0.609,6.3,116,37,79,0.319,213,0.545,14,0.583,7.4,2018-19
172,203914,Gary Harris,1610612743,DEN,57,38,19,1639.0,41,15,26,0.366,114,0.36,1,0.363,11.2,119,21,97,0.176,206,0.578,14,0.62,11.2,160,36,123,0.225,316,0.506,15,0.532,11.2,2018-19
173,1627780,Gary Payton II,1610612764,WAS,3,2,1,16.0,1,1,0,1.0,1,1.0,0,1.0,3.0,1,0,1,0.0,5,0.2,1,0.25,2.1,2,1,1,0.5,6,0.333,1,0.4,2.5,2018-19
174,1629018,Gary Trent Jr.,1610612757,POR,15,14,1,111.0,1,0,1,0.0,3,0.333,1,0.5,14.7,10,1,9,0.1,19,0.526,2,0.588,7.3,11,1,10,0.091,22,0.5,3,0.579,8.0,2018-19
175,201588,George Hill,1610612749,MIL,60,39,21,1302.0,39,18,21,0.462,97,0.402,4,0.419,8.6,109,19,90,0.174,208,0.524,13,0.559,8.4,148,37,111,0.25,302,0.49,17,0.519,8.5,2018-19
176,1628994,George King,1610612756,PHX,1,0,1,6.0,0,0,0,0.0,0,0.0,0,0.0,0.0,1,0,1,0.0,2,0.5,0,0.5,11.6,1,0,1,0.0,2,0.5,0,0.5,11.6,2018-19
177,1627777,Georges Niang,1610612762,UTA,59,41,18,516.0,11,3,8,0.273,30,0.367,1,0.379,18.3,76,14,62,0.184,124,0.613,9,0.661,6.5,87,17,70,0.195,145,0.6,10,0.644,8.0,2018-19
178,101123,Gerald Green,1610612745,HOU,73,47,26,1473.0,30,5,23,0.167,72,0.417,4,0.441,13.8,152,22,128,0.145,274,0.555,23,0.606,7.7,182,27,151,0.148,334,0.545,27,0.593,8.6,2018-19
179,203507,Giannis Antetokounmpo,1610612749,MIL,72,56,16,2358.0,159,109,49,0.686,401,0.397,9,0.406,6.4,739,196,542,0.265,1044,0.708,74,0.762,4.6,898,305,591,0.34,1378,0.652,83,0.693,5.0,2018-19
180,203922,Glenn Robinson III,1610612765,DET,47,24,23,610.0,17,8,9,0.471,57,0.298,5,0.327,7.8,54,11,43,0.204,108,0.5,7,0.535,7.2,71,19,52,0.268,158,0.449,12,0.486,7.3,2018-19
181,201609,Goran Dragic,1610612748,MIA,36,16,20,991.0,20,5,15,0.25,60,0.333,4,0.357,12.7,91,11,80,0.121,169,0.538,17,0.599,9.1,111,16,95,0.144,226,0.491,21,0.541,9.7,2018-19
182,202330,Gordon Hayward,1610612738,BOS,72,44,28,1863.0,51,28,25,0.549,172,0.297,6,0.307,9.8,271,40,231,0.148,418,0.648,25,0.69,7.3,322,68,256,0.211,558,0.577,31,0.611,7.7,2018-19
183,203476,Gorgui Dieng,1610612750,MIN,76,33,43,1031.0,81,51,29,0.63,210,0.386,4,0.393,7.0,230,57,172,0.248,366,0.628,27,0.678,5.0,311,108,201,0.347,546,0.57,31,0.604,5.5,2018-19
184,1628960,Grayson Allen,1610612762,UTA,38,22,16,416.0,3,1,2,0.333,6,0.5,0,0.5,18.5,20,3,18,0.15,28,0.714,5,0.87,10.6,23,4,20,0.174,34,0.676,5,0.793,11.6,2018-19
185,202328,Greg Monroe,1610612755,PHI,43,28,15,480.0,67,46,21,0.687,148,0.453,3,0.462,4.9,105,36,69,0.343,164,0.64,13,0.695,4.4,172,82,90,0.477,302,0.57,16,0.601,4.6,2018-19
186,1627824,Guerschon Yabusele,1610612738,BOS,41,27,14,251.0,23,13,9,0.565,40,0.575,1,0.59,8.6,30,10,20,0.333,58,0.517,8,0.6,6.1,53,23,29,0.434,96,0.552,9,0.609,7.2,2018-19
187,1628977,Hamidou Diallo,1610612760,OKC,50,28,22,522.0,38,23,15,0.605,76,0.5,2,0.514,5.1,59,14,45,0.237,92,0.641,6,0.686,8.6,97,37,60,0.381,165,0.588,8,0.618,7.2,2018-19
188,203084,Harrison Barnes,1610612758,SAC,77,34,43,2533.0,57,29,28,0.509,177,0.322,7,0.335,8.8,304,65,239,0.214,495,0.614,42,0.671,6.7,361,94,267,0.26,647,0.558,49,0.604,7.0,2018-19
189,1628385,Harry Giles III,1610612758,SAC,58,26,32,820.0,66,49,16,0.742,140,0.471,3,0.482,4.6,156,51,105,0.327,282,0.553,30,0.619,4.9,222,100,121,0.45,404,0.55,33,0.598,4.8,2018-19
190,202355,Hassan Whiteside,1610612748,MIA,72,33,39,1674.0,257,198,54,0.77,506,0.508,10,0.518,4.3,560,197,366,0.352,861,0.65,65,0.704,3.9,817,395,420,0.483,1319,0.619,75,0.657,4.1,2018-19
191,1629312,Haywood Highsmith,1610612755,PHI,5,2,3,40.0,0,0,0,0.0,5,0.0,0,0.0,0.0,5,1,4,0.2,7,0.714,0,0.714,7.0,5,1,4,0.2,11,0.455,0,0.455,7.0,2018-19
192,1627740,Henry Ellenson,1610612752,NYK,19,4,15,259.0,5,2,3,0.4,28,0.179,1,0.185,6.1,61,15,46,0.246,92,0.663,11,0.753,4.3,66,17,49,0.258,110,0.6,12,0.673,4.4,2018-19
193,203546,Ian Clark,1610612740,NOP,60,24,36,973.0,13,4,9,0.308,41,0.317,3,0.342,15.5,76,10,66,0.132,129,0.589,15,0.667,9.7,89,14,75,0.157,169,0.527,18,0.589,10.5,2018-19
194,101133,Ian Mahinmi,1610612764,WAS,33,11,22,490.0,48,29,20,0.604,114,0.421,2,0.429,5.8,80,27,51,0.338,167,0.479,16,0.53,5.6,128,56,71,0.438,276,0.464,18,0.496,5.7,2018-19
195,1628387,Ike Anigbogu,1610612754,IND,3,2,1,6.0,1,1,0,1.0,4,0.25,0,0.25,3.0,2,1,1,0.5,2,1.0,0,1.0,5.6,3,2,1,0.667,6,0.5,0,0.5,4.7,2018-19
196,202697,Iman Shumpert,1610612745,HOU,62,39,23,1481.0,27,12,15,0.444,93,0.29,7,0.314,12.2,156,25,132,0.16,262,0.595,21,0.647,7.4,183,37,147,0.202,330,0.555,28,0.606,8.1,2018-19
197,1629067,Isaac Bonga,1610612747,LAL,22,7,15,120.0,9,2,7,0.222,17,0.529,0,0.529,11.3,16,7,9,0.438,28,0.571,8,0.8,5.5,25,9,16,0.36,43,0.581,8,0.714,7.6,2018-19
198,1629353,Isaac Humphries,1610612737,ATL,5,1,4,56.0,4,1,3,0.25,8,0.5,1,0.571,7.0,7,1,6,0.143,12,0.583,1,0.636,3.6,11,2,9,0.182,19,0.579,2,0.647,4.8,2018-19
199,1628515,Isaiah Briscoe,1610612753,ORL,39,17,22,559.0,5,1,4,0.2,16,0.313,0,0.313,8.2,69,10,59,0.145,105,0.657,7,0.704,8.7,74,11,63,0.149,121,0.612,7,0.649,8.6,2018-19
200,203477,Isaiah Canaan,1610612749,MIL,30,10,20,628.0,6,2,4,0.333,20,0.3,2,0.333,21.3,52,7,44,0.135,86,0.605,12,0.703,9.3,58,9,48,0.155,104,0.558,14,0.644,10.5,2018-19
201,1628392,Isaiah Hartenstein,1610612745,HOU,28,15,13,221.0,21,17,4,0.81,61,0.344,2,0.356,5.4,26,11,14,0.423,63,0.413,4,0.441,7.1,47,28,18,0.596,120,0.392,6,0.412,6.4,2018-19
202,1628439,Isaiah Hicks,1610612752,NYK,3,1,2,32.0,2,1,1,0.5,9,0.222,0,0.222,9.9,5,1,4,0.2,10,0.5,2,0.625,3.5,7,2,5,0.286,18,0.389,2,0.438,5.3,2018-19
203,202738,Isaiah Thomas,1610612743,DEN,12,6,6,181.0,5,1,4,0.2,15,0.333,0,0.333,16.9,8,2,5,0.25,12,0.667,1,0.727,10.2,13,3,9,0.231,27,0.481,1,0.5,13.0,2018-19
204,202397,Ish Smith,1610612765,DET,56,33,23,1251.0,23,7,17,0.304,68,0.338,4,0.359,13.9,122,20,99,0.164,238,0.513,27,0.578,8.4,145,27,116,0.186,295,0.492,31,0.549,9.3,2018-19
205,1628397,Ivan Rabb,1610612763,MEM,49,20,29,721.0,70,55,15,0.786,174,0.402,6,0.417,5.8,136,51,84,0.375,216,0.63,23,0.705,4.6,206,106,99,0.515,380,0.542,29,0.587,5.0,2018-19
206,1627826,Ivica Zubac,1610612746,LAC,59,32,27,1039.0,115,90,24,0.783,264,0.436,3,0.441,4.1,247,97,150,0.393,426,0.58,49,0.655,4.3,362,187,174,0.517,670,0.54,52,0.586,4.2,2018-19
207,200826,J.J. Barea,1610612742,DAL,38,20,18,752.0,13,0,13,0.0,42,0.31,5,0.351,14.2,82,6,75,0.073,122,0.672,5,0.701,9.3,95,6,88,0.063,163,0.583,10,0.621,10.0,2018-19
208,1629122,J.P. Macura,1610612766,CHA,2,1,1,17.0,0,0,0,0.0,4,0.0,0,0.0,0.0,3,0,3,0.0,4,0.75,0,0.75,5.8,3,0,3,0.0,8,0.375,0,0.375,5.8,2018-19
209,200755,JJ Redick,1610612755,PHI,75,49,26,2346.0,20,5,15,0.25,60,0.333,8,0.385,18.3,164,18,146,0.11,302,0.543,24,0.59,10.3,184,23,161,0.125,359,0.513,32,0.563,11.1,2018-19
210,2747,JR Smith,1610612739,CLE,11,1,10,222.0,0,0,0,0.0,7,0.0,1,0.0,0.0,18,3,15,0.167,35,0.514,3,0.563,7.3,18,3,15,0.167,38,0.474,4,0.529,7.3,2018-19
211,203960,JaKarr Sampson,1610612741,CHI,4,1,3,127.0,5,2,3,0.4,17,0.294,1,0.313,8.6,27,6,21,0.222,37,0.73,0,0.73,4.2,32,8,24,0.25,49,0.653,1,0.667,4.9,2018-19
212,203210,JaMychal Green,1610612746,LAC,65,31,34,1371.0,104,75,31,0.721,271,0.384,1,0.385,5.2,305,78,226,0.256,445,0.685,33,0.74,5.1,409,153,257,0.374,675,0.606,34,0.638,5.1,2018-19
213,201580,JaVale McGee,1610612747,LAL,75,35,40,1671.0,195,143,52,0.733,386,0.505,7,0.515,4.8,371,125,245,0.337,635,0.584,52,0.636,4.1,566,268,297,0.473,990,0.572,59,0.608,4.4,2018-19
214,203953,Jabari Parker,1610612764,WAS,63,18,45,1720.0,79,54,25,0.684,227,0.348,6,0.357,7.0,341,89,252,0.261,554,0.616,42,0.666,6.0,420,143,277,0.34,739,0.568,48,0.608,6.2,2018-19
215,1628980,Jacob Evans,1610612744,GSW,30,21,9,204.0,6,3,3,0.5,8,0.75,0,0.75,9.9,19,6,13,0.316,31,0.613,2,0.655,8.1,25,9,16,0.36,39,0.641,2,0.676,8.6,2018-19
216,203109,Jae Crowder,1610612762,UTA,79,48,31,2140.0,59,18,41,0.305,159,0.371,3,0.378,13.1,321,58,262,0.181,507,0.633,40,0.687,6.5,380,76,303,0.2,625,0.608,43,0.653,7.5,2018-19
217,1626143,Jahlil Okafor,1610612740,NOP,59,23,36,935.0,82,57,24,0.695,202,0.406,2,0.41,4.7,196,62,134,0.316,341,0.575,40,0.651,5.1,278,119,158,0.428,527,0.528,42,0.573,5.0,2018-19
218,1627774,Jake Layman,1610612757,POR,71,46,25,1327.0,56,31,24,0.554,128,0.438,4,0.452,8.9,161,36,125,0.224,277,0.581,24,0.636,6.5,217,67,149,0.309,393,0.552,28,0.595,7.1,2018-19
219,1627751,Jakob Poeltl,1610612759,SAS,77,43,34,1273.0,178,128,47,0.719,324,0.549,4,0.556,5.4,232,93,128,0.401,431,0.538,62,0.629,4.7,410,221,175,0.539,739,0.555,66,0.609,5.0,2018-19
220,1628973,Jalen Brunson,1610612742,DAL,73,27,46,1591.0,25,9,16,0.36,80,0.313,6,0.338,11.7,144,24,120,0.167,232,0.621,22,0.686,8.8,169,33,136,0.195,309,0.547,28,0.601,9.3,2018-19
221,1627883,Jalen Jones,1610612739,CLE,16,3,13,214.0,11,5,6,0.455,35,0.314,1,0.324,4.0,23,4,19,0.174,40,0.575,5,0.657,4.6,34,9,25,0.265,72,0.472,6,0.515,4.4,2018-19
222,2037,Jamal Crawford,1610612756,PHX,64,13,51,1211.0,8,1,7,0.125,21,0.381,4,0.471,20.5,77,8,69,0.104,106,0.726,7,0.778,10.9,85,9,76,0.106,125,0.68,11,0.746,11.8,2018-19
223,1627750,Jamal Murray,1610612743,DEN,75,49,26,2447.0,65,35,30,0.538,181,0.359,11,0.382,10.8,252,39,212,0.155,398,0.633,34,0.692,9.0,317,74,242,0.233,568,0.558,45,0.606,9.4,2018-19
224,203516,James Ennis III,1610612755,PHI,58,35,23,1230.0,60,38,22,0.633,148,0.405,2,0.411,6.5,122,14,107,0.115,249,0.49,37,0.575,6.4,182,52,129,0.286,388,0.469,39,0.521,6.4,2018-19
225,201935,James Harden,1610612745,HOU,78,51,27,2867.0,66,34,33,0.515,260,0.254,9,0.263,10.3,452,89,360,0.197,702,0.644,56,0.7,6.9,518,123,393,0.237,903,0.574,65,0.618,7.4,2018-19
226,201949,James Johnson,1610612748,MIA,55,27,28,1164.0,22,14,8,0.636,62,0.355,3,0.373,7.2,154,34,119,0.221,268,0.575,23,0.629,6.5,176,48,127,0.273,326,0.54,26,0.587,6.6,2018-19
227,203263,James Nunnally,1610612745,HOU,15,8,7,101.0,0,0,0,0.0,4,0.0,2,0.0,0.0,5,1,4,0.2,7,0.714,2,1.0,5.6,5,1,4,0.2,9,0.556,4,1.0,5.6,2018-19
228,201162,Jared Dudley,1610612751,BKN,59,28,31,1220.0,34,17,17,0.5,87,0.391,3,0.405,7.3,121,30,91,0.248,280,0.432,37,0.498,6.2,155,47,108,0.303,355,0.437,40,0.492,6.4,2018-19
229,1629123,Jared Terrell,1610612750,MIN,14,4,10,111.0,1,0,0,0.0,2,0.5,1,1.0,0.0,5,0,5,0.0,8,0.625,2,0.833,10.3,6,0,5,0.0,10,0.6,3,0.857,10.3,2018-19
230,1626185,Jarell Martin,1610612753,ORL,41,19,22,323.0,11,8,3,0.727,37,0.297,1,0.306,5.2,62,16,46,0.258,98,0.633,7,0.681,5.0,73,24,49,0.329,131,0.557,8,0.593,5.0,2018-19
231,1628991,Jaren Jackson Jr.,1610612763,MEM,58,23,35,1515.0,73,60,14,0.822,182,0.401,7,0.417,5.6,199,80,117,0.402,379,0.525,37,0.582,6.3,272,140,131,0.515,555,0.49,44,0.532,6.1,2018-19
232,1628417,Jaron Blossomgame,1610612739,CLE,27,4,23,439.0,26,13,12,0.5,56,0.464,0,0.464,6.1,72,16,55,0.222,118,0.61,10,0.667,4.2,98,29,67,0.296,171,0.573,10,0.609,4.7,2018-19
233,1629020,Jarred Vanderbilt,1610612743,DEN,17,10,7,69.0,7,6,0,0.857,19,0.368,1,0.389,3.7,16,5,11,0.313,26,0.615,5,0.762,4.5,23,11,11,0.478,45,0.511,6,0.59,4.3,2018-19
234,1628386,Jarrett Allen,1610612751,BKN,80,42,38,2096.0,191,127,65,0.665,452,0.423,9,0.431,5.4,481,137,343,0.285,864,0.557,75,0.61,4.5,672,264,408,0.393,1270,0.529,84,0.567,4.7,2018-19
235,201160,Jason Smith,1610612740,NOP,20,10,10,191.0,16,11,5,0.688,39,0.41,0,0.41,5.5,36,8,28,0.222,68,0.529,4,0.563,5.2,52,19,33,0.365,104,0.5,4,0.52,5.3,2018-19
236,1628393,Jawun Evans,1610612760,OKC,8,4,4,64.0,1,1,0,1.0,1,1.0,0,1.0,4.4,11,1,10,0.091,14,0.786,0,0.786,8.2,12,2,10,0.167,15,0.8,0,0.8,7.9,2018-19
237,1629121,Jaylen Adams,1610612737,ATL,34,13,21,428.0,11,4,7,0.364,26,0.423,1,0.44,14.4,49,2,48,0.041,85,0.576,6,0.62,9.2,60,6,55,0.1,109,0.55,7,0.588,10.1,2018-19
238,1627759,Jaylen Brown,1610612738,BOS,74,41,33,1913.0,65,33,31,0.508,185,0.351,8,0.367,9.1,248,45,203,0.181,431,0.575,45,0.642,6.3,313,78,234,0.249,598,0.523,53,0.574,6.8,2018-19
239,1628537,Jaylen Morris,1610612749,MIL,4,4,0,29.0,0,0,0,0.0,0,0.0,0,0.0,0.0,5,2,3,0.4,7,0.714,0,0.714,10.1,5,2,3,0.4,7,0.714,0,0.714,10.1,2018-19
240,1628369,Jayson Tatum,1610612738,BOS,79,48,31,2455.0,70,33,37,0.471,203,0.345,8,0.359,10.1,407,68,338,0.167,590,0.69,43,0.744,6.3,477,101,375,0.212,758,0.629,51,0.675,6.9,2018-19
241,201145,Jeff Green,1610612764,WAS,76,28,48,2076.0,56,31,25,0.554,126,0.444,7,0.471,8.1,250,67,182,0.268,467,0.535,45,0.592,7.1,306,98,207,0.32,577,0.53,52,0.583,7.3,2018-19
242,201952,Jeff Teague,1610612750,MIN,42,23,19,1264.0,16,4,13,0.25,66,0.242,6,0.267,15.2,90,9,81,0.1,162,0.556,15,0.612,9.8,106,13,94,0.123,224,0.473,21,0.522,10.6,2018-19
243,1629203,Jemerrio Jones,1610612747,LAL,6,3,3,143.0,16,8,8,0.5,34,0.471,2,0.5,9.7,33,7,26,0.212,53,0.623,9,0.75,5.6,49,15,34,0.306,87,0.563,11,0.645,6.9,2018-19
244,203924,Jerami Grant,1610612760,OKC,79,47,32,2578.0,96,51,42,0.531,271,0.354,16,0.376,9.0,312,83,229,0.266,581,0.537,44,0.581,7.2,408,134,271,0.328,826,0.494,60,0.533,7.6,2018-19
245,203087,Jeremy Lamb,1610612766,CHA,79,38,41,2250.0,65,34,30,0.523,173,0.376,4,0.385,7.6,369,78,291,0.211,615,0.6,57,0.661,5.6,434,112,321,0.258,773,0.561,61,0.61,5.9,2018-19
246,202391,Jeremy Lin,1610612761,TOR,74,31,43,1436.0,22,7,15,0.318,78,0.282,3,0.293,16.3,157,28,128,0.178,287,0.547,30,0.611,8.2,179,35,143,0.196,359,0.499,33,0.549,9.2,2018-19
247,1626170,Jerian Grant,1610612753,ORL,58,26,32,910.0,19,6,13,0.316,45,0.422,2,0.442,16.8,74,12,63,0.162,135,0.548,12,0.602,8.5,93,18,76,0.194,177,0.525,14,0.571,10.2,2018-19
248,1629010,Jerome Robinson,1610612746,LAC,33,18,15,321.0,3,1,2,0.333,12,0.25,1,0.273,16.4,38,5,32,0.132,62,0.613,7,0.691,6.9,41,6,34,0.146,74,0.554,8,0.621,7.6,2018-19
249,201573,Jerryd Bayless,1610612750,MIN,34,15,19,657.0,11,2,10,0.182,33,0.333,1,0.344,25.0,51,7,44,0.137,92,0.554,9,0.614,8.0,62,9,54,0.145,124,0.5,10,0.544,11.2,2018-19
250,1628975,Jevon Carter,1610612763,MEM,39,9,30,576.0,14,2,12,0.143,29,0.483,1,0.5,19.9,52,8,43,0.154,89,0.584,9,0.65,9.8,66,10,55,0.152,116,0.569,10,0.623,11.9,2018-19
251,202690,Jimmer Fredette,1610612756,PHX,6,1,5,65.0,1,0,1,0.0,3,0.333,0,0.333,22.5,6,0,6,0.0,13,0.462,2,0.545,8.7,7,0,7,0.0,16,0.438,2,0.5,10.7,2018-19
252,202710,Jimmy Butler,1610612755,PHI,64,38,26,2147.0,120,82,39,0.683,230,0.522,9,0.543,8.3,219,46,172,0.21,377,0.581,35,0.64,7.6,339,128,211,0.378,604,0.561,44,0.605,7.8,2018-19
253,201149,Joakim Noah,1610612763,MEM,42,14,28,693.0,58,40,16,0.69,169,0.343,3,0.349,5.5,180,62,118,0.344,289,0.623,16,0.659,4.1,238,102,134,0.429,439,0.542,19,0.567,4.4,2018-19
254,201975,Jodie Meeks,1610612761,TOR,8,7,1,104.0,1,0,1,0.0,4,0.25,1,0.333,26.9,11,1,10,0.091,20,0.55,0,0.55,8.7,12,1,11,0.083,24,0.5,1,0.522,10.2,2018-19
255,1629147,Joe Chealey,1610612766,CHA,1,0,1,8.0,0,0,0,0.0,0,0.0,0,0.0,0.0,0,0,0,0.0,0,0.0,1,0.0,0.0,0,0,0,0.0,0,0.0,1,0.0,0.0,2018-19
256,203925,Joe Harris,1610612751,BKN,76,41,35,2294.0,52,26,27,0.5,168,0.31,6,0.321,10.6,239,67,171,0.28,494,0.484,50,0.538,6.7,291,93,198,0.32,650,0.448,56,0.49,7.4,2018-19
257,204060,Joe Ingles,1610612762,UTA,81,50,31,2534.0,34,11,23,0.324,104,0.327,6,0.347,13.1,291,45,246,0.155,469,0.62,41,0.68,7.9,325,56,269,0.172,563,0.577,47,0.63,8.5,2018-19
258,203954,Joel Embiid,1610612755,PHI,63,43,20,2121.0,158,111,47,0.703,437,0.362,10,0.37,4.9,705,214,492,0.304,1094,0.644,97,0.707,4.5,863,325,539,0.377,1471,0.587,107,0.633,4.6,2018-19
259,1628381,John Collins,1610612737,ATL,61,24,37,1828.0,219,167,53,0.763,531,0.412,17,0.426,4.7,376,123,252,0.327,617,0.609,59,0.674,4.1,595,290,305,0.487,1104,0.539,76,0.579,4.3,2018-19
260,203089,John Henson,1610612739,CLE,14,10,4,188.0,16,10,6,0.625,49,0.327,1,0.333,7.6,55,11,43,0.2,85,0.647,6,0.696,5.2,71,21,49,0.296,126,0.563,7,0.597,5.7,2018-19
261,204066,John Holland,1610612739,CLE,1,0,1,1.0,0,0,0,0.0,0,0.0,0,0.0,0.0,0,0,0,0.0,0,0.0,0,0.0,0.0,0,0,0,0.0,0,0.0,0,0.0,0.0,2018-19
262,203098,John Jenkins,1610612752,NYK,26,8,18,333.0,6,0,6,0.0,9,0.667,1,0.75,20.6,31,1,30,0.032,55,0.564,7,0.646,9.7,37,1,36,0.027,63,0.587,8,0.673,11.5,2018-19
263,202322,John Wall,1610612764,WAS,32,11,21,1104.0,15,4,11,0.267,63,0.238,1,0.242,15.5,101,14,87,0.139,171,0.591,22,0.678,9.7,116,18,98,0.155,233,0.498,23,0.552,10.4,2018-19
264,1628405,Johnathan Motley,1610612746,LAC,22,12,10,156.0,18,12,6,0.667,46,0.391,0,0.391,4.8,33,8,25,0.242,55,0.6,3,0.635,4.4,51,20,31,0.392,92,0.554,3,0.573,4.5,2018-19
265,1629140,Johnathan Williams,1610612747,LAL,24,10,14,372.0,48,29,19,0.604,103,0.466,3,0.48,4.9,51,14,37,0.275,87,0.586,7,0.638,5.0,99,43,56,0.434,185,0.535,10,0.566,5.0,2018-19
266,202720,Jon Leuer,1610612765,DET,41,16,25,402.0,27,18,8,0.667,67,0.403,2,0.415,4.5,70,19,51,0.271,114,0.614,13,0.693,5.0,97,37,59,0.381,173,0.561,15,0.614,4.9,2018-19
267,1628413,Jonah Bolden,1610612755,PHI,43,24,19,626.0,46,33,14,0.717,111,0.414,4,0.43,8.6,114,39,75,0.342,179,0.637,19,0.713,5.1,160,72,89,0.45,274,0.584,23,0.637,6.1,2018-19
268,201973,Jonas Jerebko,1610612744,GSW,73,52,21,1218.0,72,40,31,0.556,173,0.416,6,0.431,7.5,216,72,144,0.333,358,0.603,29,0.657,5.7,288,112,175,0.389,512,0.563,35,0.604,6.1,2018-19
269,202685,Jonas Valanciunas,1610612763,MEM,49,31,18,1091.0,106,86,19,0.811,283,0.375,7,0.384,4.2,313,126,186,0.403,505,0.62,40,0.673,3.5,419,212,205,0.506,755,0.555,47,0.592,3.7,2018-19
270,1628371,Jonathan Isaac,1610612753,ORL,73,35,38,1936.0,99,69,31,0.697,237,0.418,9,0.434,5.8,302,79,222,0.262,537,0.562,47,0.616,4.7,401,148,253,0.369,758,0.529,56,0.571,5.0,2018-19
271,203613,Jonathon Simmons,1610612755,PHI,54,23,31,1022.0,26,16,10,0.615,82,0.317,5,0.338,8.7,93,22,71,0.237,156,0.596,17,0.669,7.8,119,38,81,0.319,235,0.506,22,0.559,8.0,2018-19
272,1628395,Jordan Bell,1610612744,GSW,68,46,22,788.0,55,33,21,0.6,122,0.451,3,0.462,7.1,129,48,83,0.372,244,0.529,28,0.597,4.9,184,81,104,0.44,353,0.521,31,0.571,5.5,2018-19
273,203903,Jordan Clarkson,1610612739,CLE,81,18,63,2215.0,82,42,41,0.512,171,0.48,6,0.497,11.0,188,24,164,0.128,331,0.568,34,0.633,7.8,270,66,205,0.244,493,0.548,40,0.596,8.8,2018-19
274,1628070,Jordan Loyd,1610612761,TOR,12,11,1,55.0,1,1,0,1.0,1,1.0,0,1.0,6.6,8,2,6,0.25,13,0.615,2,0.727,7.1,9,3,6,0.333,14,0.643,2,0.75,7.0,2018-19
275,203895,Jordan McRae,1610612764,WAS,27,9,18,333.0,6,4,1,0.667,12,0.5,0,0.5,11.4,34,5,29,0.147,52,0.654,5,0.723,8.9,40,9,30,0.225,64,0.625,5,0.678,9.2,2018-19
276,1626296,Jordan Sibert,1610612737,ATL,1,1,0,4.0,0,0,0,0.0,0,0.0,0,0.0,0.0,0,0,0,0.0,0,0.0,0,0.0,0.0,0,0,0,0.0,0,0.0,0,0.0,0.0,2018-19
277,101181,Jose Calderon,1610612765,DET,49,22,27,632.0,11,2,9,0.182,29,0.379,0,0.379,14.9,49,6,43,0.122,86,0.57,7,0.62,9.1,60,8,52,0.133,112,0.536,7,0.571,10.2,2018-19
278,1628404,Josh Hart,1610612747,LAL,67,31,36,1715.0,35,15,19,0.429,117,0.299,7,0.318,12.4,213,55,158,0.258,380,0.561,43,0.632,7.0,248,70,177,0.282,489,0.507,50,0.565,7.8,2018-19
279,1628367,Josh Jackson,1610612756,PHX,79,19,60,1988.0,66,35,31,0.53,203,0.325,8,0.338,9.2,281,68,213,0.242,474,0.593,40,0.647,6.7,347,103,244,0.297,649,0.535,48,0.577,7.1,2018-19
280,1629006,Josh Okogie,1610612750,MIN,74,32,42,1757.0,41,26,14,0.634,113,0.363,8,0.39,8.7,177,40,137,0.226,320,0.553,35,0.621,7.4,218,66,151,0.303,432,0.505,43,0.56,7.7,2018-19
281,1626196,Josh Richardson,1610612748,MIA,73,35,38,2539.0,54,17,37,0.315,154,0.351,7,0.367,12.3,209,32,176,0.153,378,0.553,46,0.63,10.1,263,49,213,0.186,521,0.505,53,0.562,10.5,2018-19
282,201950,Jrue Holiday,1610612740,NOP,67,30,37,2402.0,75,42,31,0.56,206,0.364,10,0.383,8.8,259,53,207,0.205,441,0.587,42,0.649,8.1,334,95,238,0.284,637,0.524,52,0.571,8.3,2018-19
283,1627823,Juancho Hernangomez,1610612743,DEN,70,44,26,1358.0,64,38,25,0.594,163,0.393,5,0.405,7.0,201,37,165,0.184,325,0.618,25,0.67,5.9,265,75,190,0.283,468,0.566,30,0.605,6.1,2018-19
284,1627395,Julian Washburn,1610612763,MEM,18,7,11,254.0,8,4,4,0.5,20,0.4,0,0.4,6.8,33,9,24,0.273,55,0.6,5,0.66,7.1,41,13,28,0.317,72,0.569,5,0.612,7.0,2018-19
285,203944,Julius Randle,1610612740,NOP,73,31,42,2232.0,162,112,47,0.691,416,0.389,16,0.405,5.1,472,124,348,0.263,726,0.65,59,0.708,5.0,634,236,395,0.372,1085,0.584,75,0.628,5.0,2018-19
286,1626147,Justin Anderson,1610612737,ATL,48,17,31,464.0,24,15,10,0.625,49,0.49,3,0.522,7.4,60,9,50,0.15,91,0.659,7,0.714,6.1,84,24,60,0.286,135,0.622,10,0.672,6.5,2018-19
287,203200,Justin Holiday,1610612763,MEM,81,25,56,2568.0,45,17,28,0.378,109,0.413,1,0.417,13.2,273,50,220,0.183,473,0.577,40,0.63,7.1,318,67,248,0.211,560,0.568,41,0.613,8.0,2018-19
288,1628382,Justin Jackson,1610612742,DAL,81,36,45,1613.0,44,18,26,0.409,85,0.518,6,0.557,9.8,168,41,127,0.244,275,0.611,28,0.68,8.2,212,59,153,0.278,352,0.602,34,0.667,8.5,2018-19
289,1628383,Justin Patton,1610612755,PHI,3,2,1,21.0,2,2,0,1.0,7,0.286,1,0.333,2.5,4,2,2,0.5,5,0.8,0,0.8,4.7,6,4,2,0.667,11,0.545,1,0.6,4.0,2018-19
290,1626159,Justise Winslow,1610612748,MIA,66,30,36,1960.0,63,30,32,0.476,188,0.335,9,0.352,10.5,292,70,221,0.24,552,0.529,75,0.612,6.2,355,100,253,0.282,721,0.492,84,0.557,6.9,2018-19
291,203994,Jusuf Nurkic,1610612757,POR,72,45,27,1974.0,243,186,54,0.765,513,0.474,17,0.49,5.0,505,153,351,0.303,838,0.603,87,0.672,4.1,748,339,405,0.453,1322,0.566,104,0.614,4.4,2018-19
292,1628443,Kadeem Allen,1610612752,NYK,19,3,16,416.0,8,5,3,0.625,21,0.381,2,0.421,9.9,43,9,34,0.209,78,0.551,9,0.623,7.5,51,14,37,0.275,97,0.526,11,0.593,7.9,2018-19
293,203564,Kalin Lucas,1610612765,DET,1,0,1,6.0,0,0,0,0.0,1,0.0,0,0.0,0.0,3,1,2,0.333,3,1.0,0,1.0,10.5,3,1,2,0.333,4,0.75,0,0.75,10.5,2018-19
294,1626157,Karl-Anthony Towns,1610612750,MIN,77,34,43,2545.0,263,175,88,0.665,567,0.464,8,0.47,6.5,691,230,458,0.333,1058,0.653,80,0.707,4.6,954,405,546,0.425,1562,0.611,88,0.647,5.2,2018-19
295,202695,Kawhi Leonard,1610612761,TOR,60,41,19,2040.0,78,54,23,0.692,207,0.377,12,0.4,7.1,361,111,249,0.307,536,0.674,30,0.713,6.6,439,165,272,0.376,712,0.617,42,0.655,6.7,2018-19
296,1628966,Keita Bates-Diop,1610612750,MIN,30,10,20,503.0,16,8,8,0.5,40,0.4,1,0.41,7.7,67,15,52,0.224,115,0.583,7,0.62,6.9,83,23,60,0.277,153,0.542,8,0.572,7.0,2018-19
297,203482,Kelly Olynyk,1610612748,MIA,79,39,40,1812.0,72,43,29,0.597,213,0.338,8,0.351,7.7,303,66,236,0.218,510,0.594,44,0.65,6.3,375,109,265,0.291,694,0.54,52,0.584,6.5,2018-19
298,1626162,Kelly Oubre Jr.,1610612756,PHX,69,21,48,1935.0,71,52,19,0.732,232,0.306,9,0.318,7.4,254,56,199,0.22,459,0.553,34,0.598,6.0,325,108,218,0.332,666,0.488,43,0.522,6.3,2018-19
299,202689,Kemba Walker,1610612766,CHA,82,39,43,2863.0,52,20,32,0.385,239,0.218,13,0.23,12.6,309,63,247,0.204,540,0.572,53,0.634,9.0,361,83,279,0.23,766,0.471,66,0.516,9.5,2018-19
300,202702,Kenneth Faried,1610612745,HOU,37,21,16,728.0,97,66,31,0.68,183,0.53,2,0.536,5.1,153,48,104,0.314,243,0.63,17,0.677,4.7,250,114,135,0.456,416,0.601,19,0.63,4.9,2018-19
301,1629026,Kenrich Williams,1610612740,NOP,46,17,29,1079.0,55,27,25,0.491,131,0.42,3,0.43,9.3,164,43,123,0.262,279,0.588,33,0.667,6.4,219,70,148,0.32,398,0.55,36,0.605,7.1,2018-19
302,203145,Kent Bazemore,1610612737,ATL,67,24,43,1643.0,37,15,22,0.405,106,0.349,7,0.374,13.8,224,37,187,0.165,390,0.574,27,0.617,6.9,261,52,209,0.199,484,0.539,34,0.58,7.9,2018-19
303,203484,Kentavious Caldwell-Pope,1610612747,LAL,82,37,45,2035.0,48,18,29,0.375,117,0.41,5,0.429,13.8,190,24,166,0.126,329,0.578,38,0.653,7.0,238,42,195,0.176,441,0.54,43,0.598,8.3,2018-19
304,201142,Kevin Durant,1610612744,GSW,78,54,24,2702.0,33,16,17,0.485,133,0.248,10,0.268,11.9,464,98,365,0.211,666,0.697,45,0.747,6.1,497,114,382,0.229,764,0.651,55,0.701,6.5,2018-19
305,1628989,Kevin Huerter,1610612737,ATL,75,27,48,2049.0,60,23,36,0.383,148,0.405,8,0.429,11.8,185,34,151,0.184,322,0.575,22,0.617,8.1,245,57,187,0.233,463,0.529,30,0.566,9.0,2018-19
306,1628995,Kevin Knox II,1610612752,NYK,74,15,59,2127.0,60,34,28,0.567,166,0.361,5,0.373,9.9,271,59,211,0.218,451,0.601,36,0.653,6.4,331,93,239,0.281,604,0.548,41,0.588,7.0,2018-19
307,201567,Kevin Love,1610612739,CLE,22,7,15,598.0,33,27,5,0.818,87,0.379,3,0.393,5.3,206,48,155,0.233,279,0.738,18,0.789,4.8,239,75,160,0.314,353,0.677,21,0.72,4.8,2018-19
308,1626172,Kevon Looney,1610612744,GSW,80,56,24,1481.0,194,133,61,0.686,362,0.536,18,0.564,5.0,223,92,131,0.413,423,0.527,41,0.584,5.3,417,225,192,0.54,758,0.55,59,0.597,5.2,2018-19
309,203920,Khem Birch,1610612753,ORL,50,26,24,643.0,79,61,16,0.772,155,0.51,4,0.523,5.0,111,43,68,0.387,197,0.563,19,0.624,5.2,190,104,84,0.547,344,0.552,23,0.592,5.1,2018-19
310,203114,Khris Middleton,1610612749,MIL,77,56,21,2393.0,50,31,19,0.62,165,0.303,7,0.316,8.8,411,56,355,0.136,627,0.656,41,0.701,6.7,461,87,374,0.189,775,0.595,48,0.634,6.9,2018-19
311,1629017,Khyri Thomas,1610612765,DET,26,13,13,195.0,4,2,2,0.5,6,0.667,0,0.667,12.0,16,1,15,0.063,24,0.667,2,0.727,7.3,20,3,17,0.15,28,0.714,2,0.769,8.3,2018-19
312,202691,Klay Thompson,1610612744,GSW,78,55,23,2652.0,37,14,24,0.378,109,0.339,5,0.356,11.7,262,49,215,0.187,494,0.53,59,0.602,7.7,299,63,239,0.211,594,0.503,64,0.564,8.2,2018-19
313,1628424,Kobi Simmons,1610612739,CLE,1,0,1,2.0,0,0,0,0.0,0,0.0,0,0.0,0.0,0,0,0,0.0,0,0.0,0,0.0,0.0,0,0,0,0.0,0,0.0,0,0.0,0.0,2018-19
314,201585,Kosta Koufos,1610612758,SAC,42,21,21,502.0,52,28,24,0.538,131,0.397,9,0.426,6.3,125,43,82,0.344,210,0.595,7,0.616,4.3,177,71,106,0.401,318,0.557,16,0.586,4.9,2018-19
315,1628961,Kostas Antetokounmpo,1610612742,DAL,2,1,1,11.0,0,0,0,0.0,0,0.0,0,0.0,0.0,1,0,1,0.0,1,1.0,0,1.0,5.8,1,0,1,0.0,1,1.0,0,1.0,5.8,2018-19
316,1627739,Kris Dunn,1610612741,CHI,45,14,31,1363.0,19,6,13,0.316,64,0.297,3,0.311,14.6,164,24,139,0.146,272,0.603,29,0.675,6.6,183,30,152,0.164,333,0.55,32,0.608,7.5,2018-19
317,203937,Kyle Anderson,1610612763,MEM,43,19,24,1282.0,48,26,22,0.542,126,0.381,0,0.381,7.7,203,45,159,0.222,308,0.659,19,0.702,7.0,251,71,181,0.283,411,0.611,19,0.64,7.1,2018-19
318,2594,Kyle Korver,1610612762,UTA,69,39,30,1317.0,9,3,6,0.333,32,0.281,2,0.3,21.0,150,19,131,0.127,272,0.551,34,0.63,7.6,159,22,137,0.138,295,0.539,36,0.614,8.3,2018-19
319,1628398,Kyle Kuzma,1610612747,LAL,70,33,37,2314.0,60,33,27,0.55,195,0.308,8,0.321,10.9,322,62,258,0.193,568,0.567,48,0.619,6.7,382,95,285,0.249,738,0.518,56,0.56,7.3,2018-19
320,200768,Kyle Lowry,1610612761,TOR,65,47,18,2213.0,41,23,18,0.561,151,0.272,4,0.279,10.3,271,51,220,0.188,492,0.551,31,0.588,8.1,312,74,238,0.237,642,0.486,35,0.514,8.4,2018-19
321,203124,Kyle O'Quinn,1610612754,IND,45,27,18,371.0,29,20,8,0.69,67,0.433,3,0.453,5.7,90,28,62,0.311,143,0.629,10,0.677,4.4,119,48,70,0.403,201,0.592,13,0.633,4.7,2018-19
322,202681,Kyrie Irving,1610612738,BOS,67,37,30,2214.0,71,37,34,0.521,186,0.382,9,0.401,10.3,264,41,225,0.155,447,0.591,26,0.627,8.6,335,78,259,0.233,627,0.534,35,0.566,8.9,2018-19
323,200746,LaMarcus Aldridge,1610612759,SAS,81,48,33,2687.0,251,184,64,0.733,530,0.474,8,0.481,5.2,493,153,337,0.31,802,0.615,68,0.672,6.0,744,337,401,0.453,1296,0.574,76,0.61,5.7,2018-19
324,202362,Lance Stephenson,1610612747,LAL,68,33,35,1123.0,32,16,16,0.5,95,0.337,2,0.344,9.6,183,34,148,0.186,291,0.629,23,0.683,6.2,215,50,164,0.233,382,0.563,25,0.602,6.7,2018-19
325,202498,Lance Thomas,1610612752,NYK,46,7,39,783.0,21,11,10,0.524,73,0.288,4,0.304,7.1,96,28,68,0.292,140,0.686,13,0.756,7.4,117,39,78,0.333,199,0.588,17,0.643,7.4,2018-19
326,1629013,Landry Shamet,1610612746,LAC,78,51,27,1787.0,20,5,15,0.25,47,0.426,2,0.444,16.9,112,14,98,0.125,214,0.523,25,0.593,9.3,132,19,113,0.144,252,0.524,27,0.587,10.4,2018-19
327,204038,Langston Galloway,1610612765,DET,80,41,39,1745.0,49,15,34,0.306,101,0.485,0,0.485,14.1,122,15,107,0.123,186,0.656,13,0.705,10.1,171,30,141,0.175,279,0.613,13,0.643,11.2,2018-19
328,1626204,Larry Nance Jr.,1610612739,CLE,67,16,51,1795.0,168,108,57,0.643,359,0.468,6,0.476,5.7,384,109,272,0.284,594,0.646,39,0.692,4.7,552,217,329,0.393,927,0.595,45,0.626,5.0,2018-19
329,1628374,Lauri Markkanen,1610612741,CHI,51,16,35,1654.0,74,46,28,0.622,182,0.407,4,0.416,6.9,391,105,288,0.269,531,0.736,24,0.771,5.0,465,151,316,0.325,679,0.685,28,0.714,5.3,2018-19
330,2544,LeBron James,1610612747,LAL,55,28,27,1937.0,57,35,21,0.614,183,0.311,9,0.328,8.7,408,91,317,0.223,579,0.705,35,0.75,6.7,465,126,338,0.271,730,0.637,44,0.678,6.9,2018-19
331,1629022,Lonnie Walker IV,1610612759,SAS,17,12,5,118.0,0,0,0,0.0,5,0.0,0,0.0,0.0,17,5,12,0.294,24,0.708,2,0.773,7.0,17,5,12,0.294,27,0.63,2,0.68,7.0,2018-19
332,1628366,Lonzo Ball,1610612747,LAL,47,25,22,1423.0,54,35,18,0.648,134,0.403,7,0.425,8.2,197,47,149,0.239,297,0.663,28,0.732,6.6,251,82,167,0.327,425,0.591,35,0.644,6.9,2018-19
333,203485,Lorenzo Brown,1610612761,TOR,26,20,6,212.0,5,3,2,0.6,15,0.333,2,0.385,9.0,26,3,22,0.115,41,0.634,3,0.684,5.1,31,6,24,0.194,56,0.554,5,0.608,5.7,2018-19
334,101150,Lou Williams,1610612746,LAC,75,47,28,1993.0,40,19,21,0.475,110,0.364,5,0.381,10.5,182,19,164,0.104,294,0.619,20,0.664,8.9,222,38,185,0.171,399,0.556,25,0.594,9.3,2018-19
335,201601,Luc Mbah a Moute,1610612746,LAC,4,2,2,61.0,2,1,1,0.5,5,0.4,1,0.5,9.4,5,1,3,0.2,12,0.417,1,0.455,7.6,7,2,4,0.286,16,0.438,2,0.5,8.2,2018-19
336,1629029,Luka Doncic,1610612742,DAL,72,28,44,2318.0,86,57,29,0.663,216,0.398,8,0.413,7.9,477,93,384,0.195,731,0.653,63,0.714,5.7,563,150,413,0.266,926,0.608,71,0.658,6.0,2018-19
337,1628379,Luke Kennard,1610612765,DET,63,30,33,1437.0,12,4,8,0.333,43,0.279,1,0.286,13.6,171,25,145,0.146,245,0.698,11,0.731,7.6,183,29,153,0.158,283,0.647,12,0.675,8.0,2018-19
338,1628436,Luke Kornet,1610612752,NYK,45,9,36,750.0,27,15,11,0.556,58,0.466,0,0.466,7.8,105,39,66,0.371,207,0.507,30,0.593,6.4,132,54,77,0.409,254,0.52,30,0.589,6.7,2018-19
339,2736,Luol Deng,1610612750,MIN,22,11,11,392.0,20,8,12,0.4,46,0.435,4,0.476,9.3,53,9,44,0.17,87,0.609,6,0.654,5.4,73,17,56,0.233,128,0.57,10,0.619,6.5,2018-19
340,1627781,Malachi Richardson,1610612761,TOR,22,16,6,103.0,2,0,1,0.0,3,0.667,0,0.667,24.7,11,1,10,0.091,15,0.733,1,0.786,6.3,13,1,11,0.077,17,0.765,1,0.813,7.9,2018-19
341,1627763,Malcolm Brogdon,1610612749,MIL,64,49,15,1832.0,65,34,29,0.523,149,0.436,1,0.439,10.9,223,39,184,0.175,368,0.606,34,0.668,8.0,288,73,213,0.253,516,0.558,35,0.599,8.7,2018-19
342,1626259,Malcolm Miller,1610612761,TOR,10,9,1,67.0,1,0,1,0.0,2,0.5,0,0.5,3.1,4,1,3,0.25,5,0.8,1,1.0,6.0,5,1,4,0.2,6,0.833,1,1.0,5.4,2018-19
343,1627736,Malik Beasley,1610612743,DEN,81,53,28,1879.0,35,15,20,0.429,103,0.34,7,0.365,12.5,165,30,135,0.182,282,0.585,33,0.663,8.2,200,45,155,0.225,373,0.536,40,0.601,9.0,2018-19
344,1628370,Malik Monk,1610612766,CHA,73,34,39,1258.0,16,5,11,0.313,65,0.246,4,0.262,17.1,121,14,105,0.116,182,0.665,18,0.738,7.7,137,19,116,0.139,244,0.561,22,0.617,8.8,2018-19
345,202705,MarShon Brooks,1610612763,MEM,29,15,14,387.0,12,8,4,0.667,28,0.429,0,0.429,5.5,33,4,28,0.121,54,0.611,4,0.66,7.5,45,12,32,0.267,79,0.57,4,0.6,6.9,2018-19
346,201188,Marc Gasol,1610612761,TOR,79,39,40,2436.0,80,56,21,0.7,201,0.398,5,0.408,6.5,547,183,362,0.335,866,0.632,75,0.692,4.7,627,239,383,0.381,1029,0.609,80,0.661,4.9,2018-19
347,101162,Marcin Gortat,1610612746,LAC,47,25,22,750.0,67,35,33,0.522,169,0.396,2,0.401,6.1,194,56,138,0.289,303,0.64,34,0.721,4.3,261,91,171,0.349,460,0.567,36,0.616,4.8,2018-19
348,201158,Marco Belinelli,1610612759,SAS,79,46,33,1815.0,16,2,13,0.125,62,0.258,2,0.267,18.9,182,23,154,0.126,310,0.587,28,0.645,6.9,198,25,167,0.126,362,0.547,30,0.596,7.9,2018-19
349,1629094,Marcus Derrickson,1610612744,GSW,11,9,2,67.0,8,4,4,0.5,13,0.615,0,0.615,11.7,5,3,2,0.6,14,0.357,2,0.417,6.5,13,7,6,0.538,25,0.52,2,0.565,9.7,2018-19
350,202694,Marcus Morris Sr.,1610612738,BOS,75,44,31,2091.0,76,32,43,0.421,230,0.33,3,0.335,7.9,382,85,297,0.223,601,0.636,34,0.674,5.9,458,117,340,0.255,791,0.579,37,0.607,6.2,2018-19
351,203935,Marcus Smart,1610612738,BOS,80,48,32,2200.0,57,34,23,0.596,150,0.38,4,0.39,7.9,177,47,130,0.266,335,0.528,36,0.592,8.5,234,81,153,0.346,481,0.486,40,0.531,8.3,2018-19
352,1626209,Mario Hezonja,1610612752,NYK,57,12,45,1187.0,28,12,16,0.429,92,0.304,3,0.315,8.8,205,37,168,0.18,317,0.647,27,0.707,5.9,233,49,184,0.21,385,0.605,30,0.656,6.3,2018-19
353,1628365,Markelle Fultz,1610612753,ORL,19,12,7,427.0,26,15,9,0.577,60,0.433,2,0.448,6.8,44,5,39,0.114,86,0.512,6,0.55,9.0,70,20,48,0.286,145,0.483,8,0.511,8.2,2018-19
354,202693,Markieff Morris,1610612760,OKC,58,24,34,1271.0,61,40,20,0.656,130,0.469,1,0.473,6.4,204,62,141,0.304,357,0.571,26,0.616,5.9,265,102,161,0.385,471,0.563,27,0.597,6.0,2018-19
355,1627737,Marquese Chriss,1610612739,CLE,43,17,26,499.0,40,31,9,0.775,109,0.367,4,0.381,5.9,102,31,73,0.304,177,0.576,10,0.611,6.3,142,62,82,0.437,269,0.528,14,0.557,6.2,2018-19
356,1628963,Marvin Bagley III,1610612758,SAC,62,30,32,1568.0,162,106,55,0.654,360,0.45,9,0.462,5.1,309,97,210,0.314,466,0.663,26,0.702,4.8,471,203,265,0.431,794,0.593,35,0.621,4.9,2018-19
357,101107,Marvin Williams,1610612766,CHA,75,35,40,2133.0,76,45,31,0.592,188,0.404,9,0.425,10.2,331,86,246,0.26,561,0.59,57,0.657,6.1,407,131,277,0.322,734,0.554,66,0.609,6.9,2018-19
358,203486,Mason Plumlee,1610612743,DEN,82,54,28,1731.0,165,109,57,0.661,446,0.37,15,0.383,5.3,359,96,263,0.267,625,0.574,59,0.634,4.7,524,205,320,0.391,1056,0.496,74,0.534,4.9,2018-19
359,203521,Matthew Dellavedova,1610612739,CLE,48,20,28,812.0,6,2,4,0.333,32,0.188,4,0.214,14.1,71,9,62,0.127,130,0.546,15,0.617,8.5,77,11,66,0.143,160,0.481,19,0.546,8.9,2018-19
360,203090,Maurice Harkless,1610612757,POR,60,37,23,1415.0,77,47,30,0.61,173,0.445,3,0.453,7.2,192,54,137,0.281,301,0.638,30,0.708,6.0,269,101,167,0.375,457,0.589,33,0.634,6.3,2018-19
361,1628467,Maxi Kleber,1610612742,DAL,71,30,41,1502.0,90,59,32,0.656,212,0.425,5,0.435,8.0,239,83,153,0.347,430,0.556,44,0.619,5.5,329,142,185,0.432,610,0.539,49,0.586,6.2,2018-19
362,1628982,Melvin Frazier Jr.,1610612753,ORL,10,8,2,44.0,3,1,2,0.333,3,1.0,0,1.0,4.8,2,1,1,0.5,4,0.5,0,0.5,4.7,5,2,3,0.4,7,0.714,0,0.714,4.8,2018-19
363,203086,Meyers Leonard,1610612757,POR,61,35,26,878.0,49,29,21,0.592,119,0.412,1,0.415,6.7,184,56,128,0.304,275,0.669,14,0.705,4.5,233,85,149,0.365,383,0.608,15,0.633,4.9,2018-19
364,201563,Michael Beasley,1610612747,LAL,26,11,15,277.0,13,9,5,0.692,33,0.394,1,0.406,4.5,47,9,38,0.191,82,0.573,10,0.653,5.4,60,18,43,0.3,113,0.531,11,0.588,5.2,2018-19
365,203487,Michael Carter-Williams,1610612753,ORL,28,17,11,372.0,19,10,9,0.526,39,0.487,1,0.5,9.2,51,17,34,0.333,86,0.593,9,0.662,6.3,70,27,43,0.386,124,0.565,10,0.614,7.1,2018-19
366,203077,Michael Kidd-Gilchrist,1610612766,CHA,64,29,35,1179.0,88,59,29,0.67,214,0.411,8,0.427,5.3,158,59,99,0.373,321,0.492,33,0.549,5.8,246,118,128,0.48,529,0.465,41,0.504,5.6,2018-19
367,1628969,Mikal Bridges,1610612756,PHX,82,19,63,2417.0,56,26,30,0.464,116,0.483,4,0.5,11.8,208,50,160,0.24,373,0.558,39,0.623,8.4,264,76,190,0.288,478,0.552,43,0.607,9.1,2018-19
368,201144,Mike Conley,1610612763,MEM,70,30,40,2342.0,40,14,26,0.35,123,0.325,7,0.345,13.3,199,30,169,0.151,329,0.605,24,0.652,9.5,239,44,195,0.184,452,0.529,31,0.568,10.1,2018-19
369,203488,Mike Muscala,1610612747,LAL,63,35,28,1288.0,57,31,26,0.544,158,0.361,7,0.377,6.7,186,52,133,0.28,377,0.493,52,0.572,5.8,243,83,159,0.342,526,0.462,59,0.52,6.0,2018-19
370,203118,Mike Scott,1610612755,PHI,79,44,35,1396.0,43,18,26,0.419,115,0.374,2,0.381,12.0,233,55,177,0.236,375,0.621,32,0.679,5.9,276,73,203,0.264,462,0.597,34,0.645,6.8,2018-19
371,1628970,Miles Bridges,1610612766,CHA,80,38,42,1696.0,67,40,26,0.597,170,0.394,6,0.409,8.1,256,71,186,0.277,384,0.667,31,0.725,6.0,323,111,212,0.344,531,0.608,37,0.654,6.4,2018-19
372,203101,Miles Plumlee,1610612737,ATL,18,1,17,173.0,16,10,6,0.625,32,0.5,2,0.533,4.2,23,7,16,0.304,51,0.451,8,0.535,4.7,39,17,22,0.436,80,0.488,10,0.557,4.5,2018-19
373,1628462,Milos Teodosic,1610612746,LAC,15,8,7,150.0,3,0,2,0.0,2,1.5,0,1.5,15.8,13,1,12,0.077,17,0.765,3,0.929,6.5,16,1,14,0.063,19,0.842,3,1.0,7.8,2018-19
374,1628249,Mitchell Creek,1610612750,MIN,5,1,4,47.0,6,4,2,0.667,11,0.545,1,0.6,8.9,6,3,3,0.5,11,0.545,0,0.545,9.8,12,7,5,0.583,22,0.545,1,0.571,9.3,2018-19
375,1629011,Mitchell Robinson,1610612752,NYK,65,16,49,1350.0,175,128,45,0.731,347,0.504,2,0.507,5.4,246,84,162,0.341,403,0.61,28,0.656,6.1,421,212,207,0.504,738,0.57,30,0.595,5.8,2018-19
376,1628964,Mo Bamba,1610612753,ORL,45,17,28,733.0,61,43,16,0.705,151,0.404,5,0.418,5.9,162,57,103,0.352,270,0.6,26,0.664,3.6,223,100,119,0.448,408,0.547,31,0.592,4.2,2018-19
377,1628420,Monte Morris,1610612743,DEN,82,54,28,1970.0,35,8,27,0.229,97,0.361,4,0.376,15.9,159,24,135,0.151,264,0.602,21,0.654,9.9,194,32,162,0.165,360,0.539,25,0.579,11.0,2018-19
378,1626149,Montrezl Harrell,1610612746,LAC,82,48,34,2158.0,184,122,62,0.663,440,0.418,11,0.429,4.5,351,146,206,0.416,663,0.529,76,0.598,5.5,535,268,268,0.501,1059,0.505,87,0.55,5.2,2018-19
379,1629021,Moritz Wagner,1610612747,LAL,43,15,28,446.0,17,11,6,0.647,51,0.333,5,0.37,7.7,68,24,44,0.353,109,0.624,11,0.694,4.5,85,35,50,0.412,152,0.559,16,0.625,5.2,2018-19
380,1626167,Myles Turner,1610612754,IND,74,43,31,2119.0,101,66,35,0.653,249,0.406,9,0.421,5.7,430,161,268,0.374,842,0.511,92,0.573,4.2,531,227,303,0.427,1061,0.5,101,0.553,4.5,2018-19
381,1628513,Naz Mitrou-Long,1610612762,UTA,14,9,5,84.0,1,0,1,0.0,2,0.5,0,0.5,14.6,5,0,5,0.0,10,0.5,2,0.625,9.8,6,0,6,0.0,12,0.5,2,0.6,10.6,2018-19
382,202357,Nemanja Bjelica,1610612758,SAC,77,38,39,1788.0,125,97,27,0.776,246,0.508,8,0.525,5.2,319,95,223,0.298,519,0.615,41,0.667,5.2,444,192,250,0.432,736,0.603,49,0.646,5.2,2018-19
383,2403,Nene,1610612745,HOU,42,29,13,546.0,34,19,15,0.559,104,0.327,7,0.351,6.7,89,33,56,0.371,154,0.578,11,0.622,5.3,123,52,71,0.423,249,0.494,18,0.532,5.7,2018-19
384,203457,Nerlens Noel,1610612760,OKC,76,47,29,1043.0,126,84,41,0.667,266,0.474,7,0.486,5.4,198,57,141,0.288,384,0.516,44,0.582,4.6,324,141,182,0.435,624,0.519,51,0.565,4.9,2018-19
385,201156,Nick Young,1610612743,DEN,4,3,1,37.0,0,0,0,0.0,0,0.0,0,0.0,0.0,1,0,1,0.0,2,0.5,1,1.0,11.0,1,0,1,0.0,2,0.5,1,1.0,11.0,2018-19
386,201587,Nicolas Batum,1610612766,CHA,75,35,40,2354.0,71,40,30,0.563,177,0.401,4,0.41,8.0,319,88,230,0.276,503,0.634,37,0.685,6.6,390,128,260,0.328,649,0.601,41,0.641,6.8,2018-19
387,203917,Nik Stauskas,1610612739,CLE,68,33,35,1015.0,18,7,11,0.389,42,0.429,3,0.462,13.9,109,12,97,0.11,166,0.657,15,0.722,6.5,127,19,108,0.15,204,0.623,18,0.683,7.5,2018-19
388,203999,Nikola Jokic,1610612743,DEN,80,53,27,2504.0,228,184,45,0.807,508,0.449,11,0.459,5.0,637,219,417,0.344,1014,0.628,73,0.677,4.2,865,403,462,0.466,1462,0.592,84,0.628,4.4,2018-19
389,202703,Nikola Mirotic,1610612749,MIL,46,24,22,1245.0,60,42,18,0.7,153,0.392,2,0.397,5.8,279,66,212,0.237,403,0.692,30,0.748,4.8,339,108,230,0.319,524,0.647,32,0.689,5.0,2018-19
390,202696,Nikola Vucevic,1610612753,ORL,78,39,39,2447.0,220,161,59,0.732,443,0.497,15,0.514,5.7,711,240,470,0.338,1070,0.664,63,0.706,4.2,931,401,529,0.431,1468,0.634,78,0.67,4.6,2018-19
391,203943,Noah Vonleh,1610612752,NYK,67,13,54,1697.0,112,78,34,0.696,296,0.378,5,0.385,6.7,406,115,292,0.283,649,0.626,41,0.668,4.5,518,193,326,0.373,912,0.568,46,0.598,5.0,2018-19
392,1626181,Norman Powell,1610612761,TOR,60,45,15,1126.0,16,10,6,0.625,59,0.271,3,0.286,11.7,123,18,104,0.146,193,0.637,16,0.695,6.9,139,28,110,0.201,242,0.574,19,0.623,7.5,2018-19
393,1628384,OG Anunoby,1610612761,TOR,67,46,21,1352.0,58,28,28,0.483,148,0.392,3,0.4,7.5,139,41,97,0.295,237,0.586,13,0.621,5.1,197,69,125,0.35,360,0.547,16,0.573,5.8,2018-19
394,1627855,Okaro White,1610612764,WAS,3,2,1,6.0,1,1,0,1.0,1,1.0,0,1.0,7.3,1,0,1,0.0,1,1.0,0,1.0,10.2,2,1,1,0.5,2,1.0,0,1.0,8.8,2018-19
395,1629016,Omari Spellman,1610612737,ATL,46,15,31,805.0,72,49,23,0.681,160,0.45,5,0.465,5.4,122,41,81,0.336,225,0.542,21,0.598,5.0,194,90,104,0.464,362,0.536,26,0.577,5.1,2018-19
396,201956,Omri Casspi,1610612763,MEM,36,14,22,520.0,17,9,8,0.529,58,0.293,0,0.293,8.9,98,23,75,0.235,151,0.649,13,0.71,5.0,115,32,83,0.278,204,0.564,13,0.602,5.6,2018-19
397,203490,Otto Porter Jr.,1610612741,CHI,55,24,31,1649.0,53,32,21,0.604,159,0.333,6,0.346,8.0,250,52,195,0.208,414,0.604,28,0.648,6.0,303,84,216,0.277,550,0.551,34,0.587,6.3,2018-19
398,200782,P.J. Tucker,1610612745,HOU,82,53,29,2802.0,121,68,53,0.562,333,0.363,9,0.373,8.3,358,114,243,0.318,658,0.544,68,0.607,5.7,479,182,296,0.38,952,0.503,77,0.547,6.4,2018-19
399,1628408,PJ Dozier,1610612738,BOS,6,5,1,51.0,6,4,2,0.667,6,1.0,0,1.0,6.7,11,1,10,0.091,14,0.786,0,0.786,5.7,17,5,12,0.294,20,0.85,0,0.85,6.0,2018-19
400,1627783,Pascal Siakam,1610612761,TOR,80,57,23,2548.0,124,63,59,0.508,268,0.463,10,0.481,8.0,425,109,315,0.256,689,0.617,56,0.671,5.5,549,172,374,0.313,924,0.594,66,0.64,6.0,2018-19
401,1626192,Pat Connaughton,1610612749,MIL,61,43,18,1261.0,61,28,33,0.459,121,0.504,2,0.513,8.3,197,40,157,0.203,314,0.627,27,0.686,5.9,258,68,190,0.264,431,0.599,29,0.642,6.4,2018-19
402,201976,Patrick Beverley,1610612746,LAC,78,48,30,2137.0,76,31,42,0.408,186,0.409,14,0.442,10.5,312,44,266,0.141,521,0.599,44,0.654,7.1,388,75,308,0.193,694,0.559,58,0.61,7.7,2018-19
403,1627775,Patrick McCaw,1610612761,TOR,29,17,12,397.0,7,3,4,0.429,23,0.304,2,0.333,13.7,41,10,31,0.244,62,0.661,3,0.695,8.7,48,13,35,0.271,84,0.571,5,0.608,9.4,2018-19
404,202335,Patrick Patterson,1610612760,OKC,62,39,23,847.0,42,20,22,0.476,82,0.512,4,0.538,9.0,104,32,72,0.308,198,0.525,16,0.571,6.1,146,52,94,0.356,271,0.539,20,0.582,6.9,2018-19
405,201988,Patty Mills,1610612759,SAS,82,48,34,1908.0,24,1,22,0.042,60,0.4,1,0.407,19.8,158,15,141,0.095,249,0.635,9,0.658,10.9,182,16,163,0.088,307,0.593,10,0.613,12.1,2018-19
406,2200,Pau Gasol,1610612749,MIL,30,17,13,361.0,22,16,6,0.727,51,0.431,0,0.431,5.7,115,39,76,0.339,167,0.689,9,0.728,4.2,137,55,82,0.401,209,0.656,9,0.685,4.4,2018-19
407,202331,Paul George,1610612760,OKC,76,45,31,2801.0,105,43,62,0.41,271,0.387,11,0.404,12.1,517,104,412,0.201,828,0.624,74,0.686,6.5,622,147,474,0.236,1072,0.58,85,0.63,7.5,2018-19
408,200794,Paul Millsap,1610612743,DEN,70,49,21,1895.0,153,107,45,0.699,377,0.406,16,0.424,6.2,352,87,266,0.247,555,0.634,43,0.688,5.7,505,194,311,0.384,895,0.564,59,0.604,5.8,2018-19
409,203112,Quincy Acy,1610612756,PHX,10,2,8,123.0,3,1,2,0.333,15,0.2,0,0.2,5.0,22,8,13,0.364,34,0.647,3,0.71,4.6,25,9,15,0.36,45,0.556,3,0.595,4.6,2018-19
410,202347,Quincy Pondexter,1610612759,SAS,53,29,24,292.0,8,3,5,0.375,20,0.4,2,0.444,9.2,38,4,34,0.105,57,0.667,15,0.905,7.9,46,7,39,0.152,76,0.605,17,0.78,8.2,2018-19
411,1626188,Quinn Cook,1610612744,GSW,74,49,25,1059.0,22,4,17,0.182,47,0.468,3,0.5,14.0,135,15,120,0.111,208,0.649,20,0.718,7.7,157,19,137,0.121,254,0.618,23,0.68,8.6,2018-19
412,1626154,RJ Hunter,1610612738,BOS,1,1,0,26.0,1,0,1,0.0,2,0.5,0,0.5,33.8,2,1,1,0.5,8,0.25,2,0.333,4.9,3,1,2,0.333,10,0.3,2,0.375,14.5,2018-19
413,200765,Rajon Rondo,1610612747,LAL,46,19,27,1369.0,34,14,20,0.412,109,0.312,4,0.324,12.7,209,26,179,0.124,325,0.643,24,0.694,8.1,243,40,199,0.165,424,0.573,28,0.614,8.7,2018-19
414,203526,Raul Neto,1610612762,UTA,37,26,11,474.0,6,1,5,0.167,21,0.286,2,0.316,12.3,56,12,44,0.214,95,0.589,15,0.7,8.8,62,13,49,0.21,115,0.539,17,0.633,9.1,2018-19
415,1628959,Rawle Alkins,1610612741,CHI,10,3,7,120.0,11,8,3,0.727,18,0.611,0,0.611,9.1,15,3,12,0.2,24,0.625,5,0.789,6.0,26,11,15,0.423,42,0.619,5,0.703,7.3,2018-19
416,1629034,Ray Spalding,1610612756,PHX,14,3,11,148.0,15,12,3,0.8,37,0.405,0,0.405,4.6,33,11,22,0.333,59,0.559,7,0.635,5.4,48,23,25,0.479,91,0.527,7,0.571,5.1,2018-19
417,101109,Raymond Felton,1610612760,OKC,33,19,14,379.0,4,0,4,0.0,13,0.308,1,0.333,17.9,30,6,24,0.2,47,0.638,4,0.698,11.1,34,6,28,0.176,60,0.567,5,0.618,11.9,2018-19
418,203493,Reggie Bullock,1610612747,LAL,63,27,36,1879.0,22,8,13,0.364,69,0.319,5,0.344,13.7,151,24,126,0.159,250,0.604,19,0.654,9.1,173,32,139,0.185,310,0.558,24,0.605,9.7,2018-19
419,202704,Reggie Jackson,1610612765,DET,82,41,41,2289.0,45,12,33,0.267,132,0.341,9,0.366,15.0,171,22,147,0.129,320,0.534,35,0.6,9.0,216,34,180,0.157,448,0.482,44,0.535,10.3,2018-19
420,1626158,Richaun Holmes,1610612756,PHX,70,16,54,1184.0,115,79,35,0.687,291,0.395,3,0.399,5.5,216,82,134,0.38,446,0.484,51,0.547,4.7,331,161,169,0.486,717,0.462,54,0.499,5.0,2018-19
421,201937,Ricky Rubio,1610612762,UTA,67,40,27,1867.0,33,10,22,0.303,79,0.418,6,0.452,16.1,206,31,174,0.15,355,0.58,38,0.65,9.0,239,41,196,0.172,432,0.553,44,0.616,10.1,2018-19
422,203496,Robert Covington,1610612750,MIN,35,20,15,1203.0,28,13,13,0.464,77,0.364,4,0.384,13.3,165,39,125,0.236,314,0.525,31,0.583,6.0,193,52,138,0.269,384,0.503,35,0.553,7.0,2018-19
423,1629057,Robert Williams III,1610612738,BOS,32,18,14,283.0,27,22,5,0.815,58,0.466,0,0.466,5.7,54,16,37,0.296,89,0.607,9,0.675,5.1,81,38,42,0.469,141,0.574,9,0.614,5.3,2018-19
424,201577,Robin Lopez,1610612741,CHI,73,20,53,1578.0,140,113,26,0.807,323,0.433,5,0.44,4.0,145,55,87,0.379,344,0.422,58,0.507,5.7,285,168,113,0.589,661,0.431,63,0.477,4.9,2018-19
425,1629066,Rodions Kurucs,1610612751,BKN,63,36,27,1294.0,56,37,17,0.661,169,0.331,5,0.341,7.4,190,42,148,0.221,332,0.572,39,0.648,6.2,246,79,165,0.321,489,0.503,44,0.553,6.4,2018-19
426,203918,Rodney Hood,1610612757,POR,72,29,43,1893.0,25,5,20,0.2,71,0.352,8,0.397,16.6,132,25,106,0.189,213,0.62,11,0.653,9.2,157,30,126,0.191,278,0.565,19,0.606,10.4,2018-19
427,203585,Rodney McGruder,1610612746,LAC,66,31,35,1550.0,60,28,30,0.467,174,0.345,11,0.368,8.2,178,34,145,0.191,309,0.576,37,0.654,8.0,238,62,175,0.261,475,0.501,48,0.557,8.1,2018-19
428,1627758,Ron Baker,1610612764,WAS,15,4,11,152.0,1,1,0,1.0,2,0.5,0,0.5,6.0,10,1,9,0.1,18,0.556,1,0.588,11.1,11,2,9,0.182,19,0.579,1,0.611,10.7,2018-19
429,1626178,Rondae Hollis-Jefferson,1610612751,BKN,59,27,32,1234.0,83,51,31,0.614,233,0.356,7,0.367,7.8,227,58,169,0.256,421,0.539,45,0.604,5.2,310,109,200,0.352,623,0.498,52,0.543,5.9,2018-19
430,1626220,Royce O'Neale,1610612762,UTA,81,50,31,1660.0,22,9,13,0.409,67,0.328,3,0.344,12.8,262,65,197,0.248,410,0.639,30,0.689,6.6,284,74,210,0.261,471,0.603,33,0.648,7.0,2018-19
431,200752,Rudy Gay,1610612759,SAS,69,42,27,1842.0,63,38,23,0.603,190,0.332,6,0.342,8.0,407,95,306,0.233,597,0.682,25,0.712,4.9,470,133,329,0.283,755,0.623,31,0.649,5.3,2018-19
432,203497,Rudy Gobert,1610612762,UTA,80,50,30,2544.0,304,208,96,0.684,689,0.441,10,0.448,5.0,724,191,532,0.264,1173,0.617,109,0.68,3.9,1028,399,628,0.388,1804,0.57,119,0.61,4.2,2018-19
433,201566,Russell Westbrook,1610612760,OKC,72,43,29,2593.0,106,42,62,0.396,368,0.288,17,0.302,9.4,691,90,596,0.13,924,0.748,37,0.779,6.6,797,132,658,0.166,1201,0.664,54,0.695,6.9,2018-19
434,201583,Ryan Anderson,1610612748,MIA,25,7,18,321.0,18,11,7,0.611,43,0.419,2,0.439,7.6,36,13,23,0.361,66,0.545,9,0.632,5.2,54,24,30,0.444,107,0.505,11,0.563,6.0,2018-19
435,1627853,Ryan Arcidiacono,1610612741,CHI,80,22,58,1939.0,27,6,20,0.222,73,0.37,4,0.391,14.0,190,24,167,0.126,351,0.541,34,0.599,8.6,217,30,187,0.138,417,0.52,38,0.573,9.2,2018-19
436,1629151,Ryan Broekhoff,1610612742,DAL,42,15,27,454.0,8,3,5,0.375,24,0.333,1,0.348,14.0,55,11,45,0.2,84,0.655,11,0.753,9.5,63,14,50,0.222,105,0.6,12,0.677,10.1,2018-19
437,1626257,Salah Mejri,1610612742,DAL,36,13,23,399.0,36,22,14,0.611,94,0.383,2,0.391,5.5,95,36,59,0.379,165,0.576,11,0.617,4.4,131,58,73,0.443,250,0.524,13,0.553,4.7,2018-19
438,1626155,Sam Dekker,1610612764,WAS,46,13,33,769.0,50,27,21,0.54,138,0.362,4,0.373,6.1,93,14,79,0.151,170,0.547,15,0.6,6.6,143,41,100,0.287,294,0.486,19,0.52,6.5,2018-19
439,203159,Scott Machado,1610612747,LAL,4,3,1,19.0,0,0,0,0.0,0,0.0,0,0.0,0.0,0,0,0,0.0,0,0.0,0,0.0,0.0,0,0,0,0.0,0,0.0,0,0.0,0.0,2018-19
440,1628400,Semi Ojeleye,1610612738,BOS,56,39,17,594.0,24,13,12,0.542,52,0.462,2,0.48,11.1,62,21,41,0.339,114,0.544,13,0.614,7.2,86,34,53,0.395,159,0.541,15,0.597,8.3,2018-19
441,201586,Serge Ibaka,1610612761,TOR,74,53,21,2010.0,156,115,41,0.737,353,0.442,6,0.45,5.1,445,139,306,0.312,762,0.584,57,0.631,4.1,601,254,347,0.423,1082,0.555,63,0.59,4.4,2018-19
442,203552,Seth Curry,1610612757,POR,74,49,25,1399.0,27,7,19,0.259,58,0.466,2,0.482,15.5,93,10,83,0.108,159,0.585,13,0.637,10.4,120,17,102,0.142,216,0.556,15,0.597,11.5,2018-19
443,203894,Shabazz Napier,1610612751,BKN,56,26,30,983.0,18,4,14,0.222,62,0.29,4,0.31,19.3,82,11,71,0.134,156,0.526,21,0.607,8.1,100,15,85,0.15,215,0.465,25,0.526,10.1,2018-19
444,1628983,Shai Gilgeous-Alexander,1610612746,LAC,82,48,34,2174.0,57,20,34,0.351,145,0.393,8,0.416,13.5,175,47,129,0.269,319,0.549,29,0.603,8.3,232,67,163,0.289,453,0.512,37,0.558,9.6,2018-19
445,1629003,Shake Milton,1610612755,PHI,20,10,10,268.0,9,1,7,0.111,18,0.5,3,0.6,12.5,26,3,23,0.115,47,0.553,7,0.65,7.0,35,4,30,0.114,65,0.538,10,0.636,8.3,2018-19
446,1627885,Shaquille Harrison,1610612741,CHI,72,20,52,1417.0,33,17,17,0.515,104,0.317,5,0.333,9.2,187,26,160,0.139,306,0.611,26,0.668,8.3,220,43,177,0.195,404,0.545,31,0.59,8.4,2018-19
447,2733,Shaun Livingston,1610612744,GSW,64,45,19,967.0,42,23,19,0.548,71,0.592,4,0.627,8.5,75,14,61,0.187,130,0.577,13,0.641,9.0,117,37,80,0.316,200,0.585,17,0.639,8.8,2018-19
448,202714,Shelvin Mack,1610612766,CHA,57,22,35,1247.0,18,7,11,0.389,58,0.31,3,0.327,16.5,86,11,75,0.128,171,0.503,20,0.57,10.0,104,18,86,0.173,228,0.456,23,0.507,11.1,2018-19
449,1628414,Sindarius Thornwell,1610612746,LAC,64,37,27,313.0,5,4,1,0.8,15,0.333,1,0.357,6.6,39,10,29,0.256,62,0.629,7,0.709,7.4,44,14,30,0.318,74,0.595,8,0.667,7.3,2018-19
450,1627746,Skal Labissiere,1610612757,POR,22,12,10,176.0,9,7,1,0.778,15,0.6,2,0.692,4.7,34,10,24,0.294,54,0.63,5,0.694,6.0,43,17,25,0.395,69,0.623,7,0.694,5.8,2018-19
451,203524,Solomon Hill,1610612740,NOP,44,14,30,879.0,34,17,18,0.5,84,0.405,5,0.43,7.3,99,25,73,0.253,164,0.604,15,0.664,7.1,133,42,91,0.316,243,0.547,20,0.596,7.2,2018-19
452,203915,Spencer Dinwiddie,1610612751,BKN,68,36,32,1914.0,26,5,20,0.192,84,0.31,3,0.321,16.0,140,20,121,0.143,242,0.579,17,0.622,9.4,166,25,141,0.151,323,0.514,20,0.548,10.4,2018-19
453,1626169,Stanley Johnson,1610612740,NOP,66,28,38,1207.0,34,22,11,0.647,108,0.315,4,0.327,10.9,183,31,152,0.169,298,0.614,26,0.673,6.9,217,53,163,0.244,388,0.559,30,0.606,7.5,2018-19
454,201939,Stephen Curry,1610612744,GSW,69,52,17,2331.0,45,19,26,0.422,144,0.313,6,0.326,11.3,324,59,265,0.182,539,0.601,41,0.651,7.7,369,78,291,0.211,683,0.54,47,0.58,8.1,2018-19
455,1628425,Sterling Brown,1610612749,MIL,58,45,13,1034.0,29,15,13,0.517,82,0.354,1,0.358,10.0,155,24,131,0.155,244,0.635,27,0.714,7.2,184,39,144,0.212,323,0.57,28,0.624,7.6,2018-19
456,203500,Steven Adams,1610612760,OKC,79,46,33,2634.0,384,255,120,0.664,799,0.481,22,0.494,5.4,367,130,238,0.354,705,0.521,73,0.581,5.2,751,385,358,0.513,1478,0.508,95,0.543,5.3,2018-19
457,1629004,Svi Mykhailiuk,1610612765,DET,42,19,23,440.0,9,3,6,0.333,13,0.692,0,0.692,12.4,27,4,22,0.148,40,0.675,4,0.75,10.3,36,7,28,0.194,53,0.679,4,0.735,10.8,2018-19
458,1628388,T.J. Leaf,1610612754,IND,58,35,23,522.0,43,26,18,0.605,80,0.538,0,0.538,6.1,82,22,60,0.268,129,0.636,9,0.683,6.4,125,48,78,0.384,200,0.625,9,0.654,6.3,2018-19
459,204456,T.J. McConnell,1610612755,PHI,75,46,29,1451.0,27,4,23,0.148,70,0.386,3,0.403,11.9,142,21,121,0.148,242,0.587,26,0.657,8.2,169,25,144,0.148,307,0.55,29,0.608,8.8,2018-19
460,203933,T.J. Warren,1610612756,PHX,43,10,33,1360.0,31,14,17,0.452,108,0.287,3,0.295,9.6,143,42,100,0.294,258,0.554,21,0.603,7.5,174,56,117,0.322,344,0.506,24,0.544,7.8,2018-19
461,1628769,Tahjere McCall,1610612751,BKN,1,0,1,8.0,0,0,0,0.0,0,0.0,0,0.0,0.0,1,0,1,0.0,1,1.0,0,1.0,6.5,1,0,1,0.0,1,1.0,0,1.0,6.5,2018-19
462,201959,Taj Gibson,1610612750,MIN,70,32,38,1686.0,172,122,49,0.709,410,0.42,13,0.433,5.8,286,78,207,0.273,476,0.601,42,0.659,5.7,458,200,256,0.437,854,0.536,55,0.573,5.7,2018-19
463,1627752,Taurean Prince,1610612737,ATL,55,19,36,1552.0,22,7,16,0.318,66,0.333,4,0.355,15.4,177,35,141,0.198,286,0.619,24,0.676,7.2,199,42,157,0.211,348,0.572,28,0.622,8.1,2018-19
464,1628390,Terrance Ferguson,1610612760,OKC,73,43,30,1902.0,33,14,21,0.424,76,0.434,5,0.465,12.9,105,19,86,0.181,204,0.515,24,0.583,9.2,138,33,107,0.239,276,0.5,29,0.559,10.0,2018-19
465,203093,Terrence Jones,1610612745,HOU,2,2,0,5.0,0,0,0,0.0,1,0.0,0,0.0,0.0,4,2,2,0.5,4,1.0,0,1.0,3.5,4,2,2,0.5,4,1.0,0,1.0,3.5,2018-19
466,203082,Terrence Ross,1610612753,ORL,79,40,39,2098.0,26,10,17,0.385,77,0.338,4,0.356,14.6,250,30,220,0.12,414,0.604,31,0.653,6.5,276,40,237,0.145,478,0.577,35,0.623,7.3,2018-19
467,1626179,Terry Rozier,1610612738,BOS,79,47,32,1791.0,32,8,23,0.25,106,0.302,8,0.327,10.6,275,43,233,0.156,463,0.594,37,0.646,7.4,307,51,256,0.166,563,0.545,45,0.593,7.7,2018-19
468,200757,Thabo Sefolosha,1610612762,UTA,49,28,21,596.0,8,3,5,0.375,39,0.205,1,0.211,13.3,114,22,92,0.193,182,0.626,19,0.699,5.7,122,25,97,0.205,207,0.589,20,0.652,6.2,2018-19
469,201152,Thaddeus Young,1610612754,IND,81,47,34,2489.0,192,130,61,0.677,461,0.416,16,0.431,5.2,331,82,242,0.248,587,0.564,46,0.612,6.0,523,212,303,0.405,1022,0.512,62,0.545,5.7,2018-19
470,1629033,Theo Pinson,1610612751,BKN,18,7,11,211.0,4,2,2,0.5,14,0.286,0,0.286,13.9,32,6,25,0.188,55,0.582,2,0.604,6.9,36,8,27,0.222,66,0.545,2,0.563,7.7,2018-19
471,1628418,Thomas Bryant,1610612764,WAS,71,28,43,1481.0,110,66,43,0.6,254,0.433,10,0.451,5.7,335,126,207,0.376,557,0.601,54,0.666,4.2,445,192,250,0.431,784,0.568,64,0.618,4.6,2018-19
472,1629118,Thomas Welsh,1610612743,DEN,11,8,3,36.0,0,0,0,0.0,3,0.0,1,0.0,0.0,4,1,3,0.25,6,0.667,1,0.8,7.7,4,1,3,0.25,8,0.5,2,0.667,7.7,2018-19
473,1627748,Thon Maker,1610612765,DET,64,44,20,972.0,41,22,19,0.537,132,0.311,6,0.325,6.7,161,35,123,0.217,304,0.53,36,0.601,6.2,202,57,142,0.282,411,0.491,42,0.547,6.3,2018-19
474,204025,Tim Frazier,1610612749,MIL,59,27,32,1120.0,41,18,23,0.439,105,0.39,7,0.418,10.4,127,18,108,0.142,211,0.602,24,0.679,7.3,168,36,131,0.214,304,0.553,31,0.615,8.1,2018-19
475,203501,Tim Hardaway Jr.,1610612742,DAL,64,14,50,2032.0,33,23,10,0.697,108,0.306,8,0.33,11.6,187,29,159,0.155,332,0.563,28,0.615,8.2,220,52,169,0.236,424,0.519,36,0.567,8.7,2018-19
476,1627789,Timothe Luwawu-Cabarrot,1610612741,CHI,50,25,25,669.0,11,5,6,0.455,45,0.244,3,0.262,14.5,86,24,61,0.279,138,0.623,16,0.705,5.9,97,29,67,0.299,176,0.551,19,0.618,6.9,2018-19
477,202699,Tobias Harris,1610612755,PHI,82,46,36,2848.0,69,36,34,0.522,231,0.299,11,0.314,8.0,576,113,461,0.196,907,0.635,83,0.699,5.6,645,149,495,0.231,1092,0.591,94,0.646,5.8,2018-19
478,203107,Tomas Satoransky,1610612764,WAS,79,31,48,2133.0,81,38,42,0.469,181,0.448,9,0.471,9.4,196,24,171,0.122,342,0.573,31,0.63,8.2,277,62,213,0.224,520,0.533,40,0.577,8.5,2018-19
479,1628396,Tony Bradley,1610612762,UTA,3,2,1,36.0,9,8,1,0.889,17,0.529,1,0.563,3.6,6,0,6,0.0,8,0.75,1,0.857,3.2,15,8,7,0.533,24,0.625,2,0.682,3.4,2018-19
480,2225,Tony Parker,1610612766,CHA,56,30,26,1003.0,14,4,10,0.286,61,0.23,7,0.259,12.7,69,5,64,0.072,109,0.633,8,0.683,10.5,83,9,74,0.108,169,0.491,15,0.539,10.9,2018-19
481,203503,Tony Snell,1610612749,MIL,74,55,19,1304.0,29,20,9,0.69,82,0.354,6,0.382,10.6,128,19,109,0.148,234,0.547,24,0.61,6.9,157,39,118,0.248,299,0.525,30,0.584,7.6,2018-19
482,1628470,Torrey Craig,1610612743,DEN,75,50,25,1503.0,89,57,33,0.64,213,0.418,7,0.432,8.3,174,35,139,0.201,306,0.569,31,0.633,7.3,263,92,172,0.35,496,0.53,38,0.574,7.7,2018-19
483,1629027,Trae Young,1610612737,ATL,81,29,52,2503.0,64,17,46,0.266,200,0.32,7,0.332,12.7,237,20,218,0.084,402,0.59,31,0.639,9.6,301,37,264,0.123,591,0.509,38,0.544,10.2,2018-19
484,1626203,Treveon Graham,1610612751,BKN,35,19,16,715.0,23,15,7,0.652,85,0.271,4,0.284,6.5,84,17,67,0.202,149,0.564,18,0.641,6.7,107,32,74,0.299,230,0.465,22,0.514,6.7,2018-19
485,1628979,Trevon Duval,1610612745,HOU,3,2,1,6.0,0,0,0,0.0,0,0.0,0,0.0,0.0,1,1,0,1.0,1,1.0,0,1.0,9.0,1,1,0,1.0,1,1.0,0,1.0,9.0,2018-19
486,2772,Trevor Ariza,1610612764,WAS,68,21,47,2310.0,48,22,25,0.458,169,0.284,1,0.286,10.6,316,70,245,0.222,500,0.632,33,0.677,6.3,364,92,270,0.253,618,0.589,34,0.623,6.9,2018-19
487,203504,Trey Burke,1610612742,DAL,58,16,42,1125.0,28,10,18,0.357,74,0.378,6,0.412,11.3,71,10,60,0.141,124,0.573,14,0.645,10.2,99,20,78,0.202,197,0.503,20,0.559,10.5,2018-19
488,1626168,Trey Lyles,1610612743,DEN,64,42,22,1120.0,44,28,16,0.636,125,0.352,4,0.364,7.3,202,52,150,0.257,338,0.598,15,0.625,5.3,246,80,166,0.325,446,0.552,19,0.576,5.7,2018-19
489,202684,Tristan Thompson,1610612739,CLE,43,8,35,1198.0,173,132,41,0.763,370,0.468,7,0.477,4.2,265,77,187,0.291,455,0.582,40,0.639,4.8,438,209,228,0.477,807,0.543,47,0.576,4.6,2018-19
490,1628972,Troy Brown Jr.,1610612764,WAS,51,19,32,720.0,35,19,15,0.543,84,0.417,1,0.422,9.7,107,26,80,0.243,162,0.66,12,0.713,7.0,142,45,95,0.317,244,0.582,13,0.615,7.6,2018-19
491,1628505,Troy Caupain,1610612753,ORL,4,3,1,16.0,1,0,1,0.0,1,1.0,0,1.0,32.4,2,1,1,0.5,4,0.5,0,0.5,5.9,3,1,2,0.333,5,0.6,0,0.6,14.8,2018-19
492,203584,Troy Daniels,1610612756,PHX,51,13,38,760.0,13,5,8,0.385,31,0.419,2,0.448,9.7,60,9,51,0.15,115,0.522,11,0.577,6.9,73,14,59,0.192,145,0.503,13,0.553,7.4,2018-19
493,1627786,Troy Williams,1610612758,SAC,21,7,14,312.0,12,6,6,0.5,39,0.308,2,0.324,7.7,47,14,33,0.298,73,0.644,4,0.681,6.0,59,20,39,0.339,109,0.541,6,0.573,6.3,2018-19
494,1628463,Tyler Cavanaugh,1610612762,UTA,11,7,4,39.0,3,1,2,0.333,4,0.75,0,0.75,15.2,5,2,3,0.4,8,0.625,1,0.714,4.5,8,3,5,0.375,12,0.667,1,0.727,8.5,2018-19
495,1629093,Tyler Davis,1610612760,OKC,1,1,0,1.0,1,1,0,1.0,1,1.0,0,1.0,2.3,0,0,0,0.0,0,0.0,0,0.0,0.0,1,1,0,1.0,1,1.0,0,1.0,2.3,2018-19
496,1628416,Tyler Dorsey,1610612763,MEM,48,11,37,698.0,27,12,13,0.444,57,0.474,3,0.5,11.0,86,10,76,0.116,131,0.656,13,0.729,7.0,113,22,89,0.195,184,0.614,16,0.673,7.9,2018-19
497,204020,Tyler Johnson,1610612756,PHX,57,26,31,1529.0,34,17,17,0.5,101,0.337,8,0.366,11.7,139,10,127,0.072,271,0.513,30,0.577,8.4,173,27,144,0.156,372,0.465,38,0.518,9.1,2018-19
498,1628399,Tyler Lydon,1610612743,DEN,25,20,5,94.0,7,6,1,0.857,20,0.35,0,0.35,5.4,11,2,9,0.182,17,0.647,0,0.647,5.7,18,8,10,0.444,36,0.5,0,0.5,5.6,2018-19
499,1627755,Tyler Ulis,1610612741,CHI,1,0,1,1.0,0,0,0,0.0,0,0.0,0,0.0,,0,0,0,0.0,0,0.0,0,0.0,,0,0,0,0.0,0,0.0,0,0.0,,2018-19
500,203092,Tyler Zeller,1610612763,MEM,6,3,3,93.0,11,7,4,0.636,36,0.306,2,0.324,5.3,13,6,7,0.462,28,0.464,6,0.591,4.6,24,13,11,0.542,62,0.387,8,0.444,4.9,2018-19
501,201936,Tyreke Evans,1610612754,IND,69,41,28,1402.0,33,17,16,0.515,114,0.289,15,0.333,11.1,168,36,132,0.214,252,0.667,19,0.721,8.4,201,53,148,0.264,359,0.56,34,0.618,8.8,2018-19
502,1627820,Tyrone Wallace,1610612746,LAC,62,34,28,628.0,20,11,8,0.55,66,0.303,1,0.308,8.8,81,18,63,0.222,137,0.591,15,0.664,6.2,101,29,71,0.287,198,0.51,16,0.555,6.7,2018-19
503,2199,Tyson Chandler,1610612747,LAL,55,26,29,875.0,92,62,31,0.674,199,0.462,7,0.479,5.0,215,74,140,0.344,376,0.572,37,0.634,4.6,307,136,171,0.443,561,0.547,44,0.594,4.7,2018-19
504,1626145,Tyus Jones,1610612750,MIN,68,29,39,1560.0,23,3,20,0.13,50,0.46,2,0.479,17.0,111,7,105,0.063,180,0.617,12,0.661,9.9,134,10,125,0.075,227,0.59,14,0.629,11.1,2018-19
505,2617,Udonis Haslem,1610612748,MIA,10,8,2,74.0,3,2,1,0.667,8,0.375,0,0.375,3.3,24,4,20,0.167,38,0.632,3,0.686,4.2,27,6,21,0.222,45,0.6,3,0.643,4.1,2018-19
506,203506,Victor Oladipo,1610612754,IND,36,25,11,1147.0,21,10,12,0.476,90,0.233,5,0.247,10.8,181,32,149,0.177,276,0.656,16,0.696,7.1,202,42,161,0.208,365,0.553,21,0.587,7.5,2018-19
507,1713,Vince Carter,1610612737,ATL,76,25,51,1330.0,31,15,16,0.484,97,0.32,5,0.337,11.3,163,54,109,0.331,325,0.502,33,0.558,5.9,194,69,125,0.356,390,0.497,38,0.551,6.8,2018-19
508,1629053,Vincent Edwards,1610612745,HOU,2,1,1,16.0,1,0,1,0.0,1,1.0,0,1.0,20.7,1,0,1,0.0,1,1.0,0,1.0,3.1,2,0,2,0.0,2,1.0,0,1.0,11.9,2018-19
509,1627735,Wade Baldwin IV,1610612757,POR,16,10,6,94.0,2,1,1,0.5,10,0.2,1,0.222,5.5,13,2,11,0.154,20,0.65,1,0.684,8.1,15,3,12,0.2,27,0.556,2,0.6,7.7,2018-19
510,1627215,Walt Lemon Jr.,1610612741,CHI,6,1,5,167.0,4,2,2,0.5,18,0.222,0,0.222,8.7,23,2,21,0.087,33,0.697,2,0.742,7.6,27,4,23,0.148,47,0.574,2,0.6,7.8,2018-19
511,201961,Wayne Ellington,1610612765,DET,53,26,27,1297.0,14,1,13,0.071,39,0.359,4,0.4,17.7,93,13,78,0.14,154,0.604,10,0.646,10.0,107,14,91,0.131,187,0.572,14,0.618,11.0,2018-19
512,1627782,Wayne Selden,1610612741,CHI,75,27,48,1439.0,37,18,20,0.486,94,0.394,3,0.407,11.8,143,30,113,0.21,222,0.644,19,0.704,8.3,180,48,133,0.267,306,0.588,22,0.634,9.0,2018-19
513,1628976,Wendell Carter Jr.,1610612741,CHI,43,10,33,1092.0,87,62,25,0.713,204,0.426,5,0.437,5.8,217,92,125,0.424,387,0.561,30,0.608,4.5,304,154,150,0.507,578,0.526,35,0.56,4.9,2018-19
514,1628411,Wes Iwundu,1610612753,ORL,68,36,32,1233.0,37,19,18,0.514,83,0.446,4,0.468,8.3,147,26,119,0.177,227,0.648,15,0.693,7.0,184,45,137,0.245,304,0.605,19,0.646,7.3,2018-19
515,202325,Wesley Johnson,1610612764,WAS,38,17,21,534.0,12,5,7,0.417,34,0.353,0,0.353,11.6,60,12,48,0.2,90,0.667,5,0.706,8.0,72,17,55,0.236,118,0.61,5,0.637,8.6,2018-19
516,202083,Wesley Matthews,1610612754,IND,69,27,42,2091.0,32,13,19,0.406,85,0.376,8,0.416,13.5,138,26,112,0.188,257,0.537,22,0.587,9.7,170,39,131,0.229,335,0.507,30,0.557,10.4,2018-19
517,203115,Will Barton,1610612743,DEN,43,27,16,1189.0,32,14,18,0.438,88,0.364,5,0.386,11.5,167,31,136,0.186,263,0.635,18,0.682,6.3,199,45,154,0.226,338,0.589,23,0.632,7.1,2018-19
518,1626161,Willie Cauley-Stein,1610612758,SAC,81,39,42,2213.0,181,105,75,0.58,411,0.44,13,0.455,7.2,497,172,325,0.346,831,0.598,80,0.662,4.5,678,277,400,0.409,1210,0.56,93,0.607,5.3,2018-19
519,1626195,Willy Hernangomez,1610612766,CHA,58,31,27,812.0,117,88,30,0.752,226,0.518,2,0.522,5.3,194,56,139,0.289,322,0.602,18,0.638,4.4,311,144,169,0.463,532,0.585,20,0.607,4.7,2018-19
520,201163,Wilson Chandler,1610612746,LAC,50,35,15,1142.0,47,31,17,0.66,111,0.423,3,0.435,7.5,161,44,117,0.273,257,0.626,11,0.654,6.0,208,75,134,0.361,358,0.581,14,0.605,6.3,2018-19
521,1628999,Yante Maten,1610612748,MIA,2,1,1,13.0,1,0,1,0.0,1,1.0,0,1.0,4.6,2,1,1,0.5,8,0.25,0,0.25,2.1,3,1,2,0.333,9,0.333,0,0.333,2.9,2018-19
522,1627812,Yogi Ferrell,1610612758,SAC,71,33,38,1067.0,13,4,9,0.308,41,0.317,5,0.361,14.1,96,8,86,0.083,166,0.578,19,0.653,9.8,109,12,95,0.11,204,0.534,24,0.606,10.3,2018-19
523,1629139,Yuta Watanabe,1610612763,MEM,15,5,10,174.0,4,1,3,0.25,10,0.4,0,0.4,12.3,27,7,20,0.259,42,0.643,3,0.692,6.6,31,8,23,0.258,52,0.596,3,0.633,7.3,2018-19
524,1628380,Zach Collins,1610612757,POR,77,51,26,1356.0,109,79,28,0.725,271,0.402,9,0.416,5.6,215,90,125,0.419,414,0.519,44,0.581,4.8,324,169,153,0.522,663,0.489,53,0.531,5.1,2018-19
525,203897,Zach LaVine,1610612741,CHI,62,16,46,2130.0,40,23,15,0.575,183,0.219,6,0.226,6.6,251,38,212,0.151,401,0.626,42,0.699,5.9,291,61,227,0.21,565,0.515,48,0.563,6.0,2018-19
526,1629155,Zach Lofton,1610612765,DET,1,1,0,4.0,0,0,0,0.0,0,0.0,0,0.0,0.0,0,0,0,0.0,0,0.0,0,0.0,0.0,0,0,0,0.0,0,0.0,0,0.0,0.0,2018-19
527,2585,Zaza Pachulia,1610612765,DET,68,35,33,878.0,99,70,25,0.707,253,0.391,4,0.398,4.6,166,61,101,0.367,328,0.506,39,0.574,4.4,265,131,126,0.494,561,0.472,43,0.512,4.4,2018-19
528,1629015,Zhaire Smith,1610612755,PHI,6,2,4,111.0,3,3,0,1.0,7,0.429,0,0.429,4.6,10,1,9,0.1,15,0.667,2,0.769,10.4,13,4,9,0.308,22,0.591,2,0.65,9.0,2018-19
529,1627753,Zhou Qi,1610612745,HOU,1,0,1,1.0,0,0,0,0.0,0,0.0,0,0.0,0.0,0,0,0,0.0,0,0.0,0,0.0,0.0,0,0,0,0.0,0,0.0,0,0.0,0.0,2018-19
0,203932,Aaron Gordon,1610612753,ORL,62,30,32,2017.0,107,72,34,0.673,199,0.538,2,0.543,6.1,368,93,274,0.253,526,0.7,40,0.757,5.9,475,165,308,0.347,701,0.678,42,0.721,5.9,2019-20
1,1628988,Aaron Holiday,1610612754,IND,66,42,24,1617.0,22,7,15,0.318,61,0.361,0,0.361,15.7,134,15,118,0.112,237,0.565,19,0.615,9.8,156,22,133,0.141,292,0.534,19,0.571,10.7,2019-20
2,1627846,Abdel Nader,1610612760,OKC,55,37,18,867.0,14,5,8,0.357,25,0.56,3,0.636,17.4,86,15,71,0.174,142,0.606,13,0.667,6.5,100,20,79,0.2,165,0.606,16,0.671,7.9,2019-20
3,1629690,Adam Mokoka,1610612741,CHI,11,3,8,112.0,7,5,2,0.714,11,0.636,0,0.636,4.0,3,2,1,0.667,7,0.429,2,0.6,3.3,10,7,3,0.7,16,0.625,2,0.714,3.8,2019-20
4,1629678,Admiral Schofield,1610612764,WAS,33,9,24,368.0,7,3,4,0.429,27,0.259,2,0.28,10.2,40,12,27,0.3,64,0.625,7,0.702,5.2,47,15,31,0.319,85,0.553,9,0.618,5.9,2019-20
5,201143,Al Horford,1610612755,PHI,67,39,28,2026.0,103,61,40,0.592,236,0.436,10,0.456,8.0,353,97,250,0.275,532,0.664,39,0.716,6.2,456,158,290,0.346,737,0.619,49,0.663,6.6,2019-20
6,202329,Al-Farouq Aminu,1610612753,ORL,18,7,11,380.0,24,16,8,0.667,55,0.436,4,0.471,4.8,63,12,51,0.19,103,0.612,5,0.643,6.4,87,28,59,0.322,152,0.572,9,0.608,5.9,2019-20
7,202692,Alec Burks,1610612755,PHI,66,21,45,1754.0,48,15,34,0.313,125,0.384,9,0.414,11.4,234,45,184,0.192,369,0.634,39,0.709,6.7,282,60,218,0.213,483,0.584,48,0.648,7.5,2019-20
8,1629346,Alen Smailagic,1610612744,GSW,14,1,13,139.0,10,6,4,0.6,24,0.417,1,0.435,6.8,17,5,12,0.294,29,0.586,4,0.68,3.2,27,11,16,0.407,52,0.519,5,0.574,4.6,2019-20
9,1627936,Alex Caruso,1610612747,LAL,64,48,16,1175.0,17,9,7,0.529,51,0.333,5,0.37,10.4,106,26,79,0.245,173,0.613,19,0.688,9.4,123,35,86,0.285,217,0.567,24,0.637,9.5,2019-20
10,203458,Alex Len,1610612758,SAC,54,18,36,956.0,97,77,21,0.794,234,0.415,9,0.431,4.5,217,74,143,0.341,372,0.583,44,0.662,4.2,314,151,164,0.481,574,0.547,53,0.603,4.3,2019-20
11,1628035,Alfonzo McKinnie,1610612739,CLE,40,11,29,593.0,37,22,14,0.595,62,0.597,1,0.607,8.1,76,18,56,0.237,129,0.589,10,0.639,5.2,113,40,70,0.354,180,0.628,11,0.669,6.1,2019-20
12,1628993,Alize Johnson,1610612754,IND,17,10,7,118.0,16,8,6,0.5,33,0.485,0,0.485,6.5,32,10,22,0.313,52,0.615,4,0.667,4.2,48,18,28,0.375,82,0.585,4,0.615,4.9,2019-20
13,203459,Allen Crabbe,1610612750,MIN,37,5,32,653.0,11,2,8,0.182,24,0.458,1,0.478,12.8,66,5,61,0.076,116,0.569,10,0.623,7.6,77,7,69,0.091,132,0.583,11,0.636,8.3,2019-20
14,1629019,Allonzo Trier,1610612752,NYK,24,2,22,291.0,6,3,4,0.5,18,0.333,2,0.375,12.7,23,2,22,0.087,43,0.535,2,0.561,7.7,29,5,26,0.172,60,0.483,4,0.518,8.8,2019-20
15,1628518,Amile Jefferson,1610612753,ORL,18,5,13,74.0,10,9,0,0.9,13,0.769,0,0.769,3.5,13,6,7,0.462,21,0.619,2,0.684,4.1,23,15,7,0.652,34,0.676,2,0.719,3.9,2019-20
16,1629599,Amir Coffey,1610612746,LAC,18,11,7,159.0,4,3,1,0.75,9,0.444,0,0.444,3.9,12,1,11,0.083,14,0.857,0,0.857,9.3,16,4,12,0.25,22,0.727,0,0.727,8.0,2019-20
17,203083,Andre Drummond,1610612739,CLE,56,21,35,1844.0,248,184,64,0.742,489,0.507,7,0.515,4.5,601,201,396,0.334,841,0.715,58,0.768,3.9,849,385,460,0.453,1279,0.664,65,0.699,4.1,2019-20
18,2738,Andre Iguodala,1610612748,MIA,20,10,10,395.0,14,5,9,0.357,31,0.452,2,0.483,11.5,58,15,43,0.259,87,0.667,6,0.716,7.4,72,20,52,0.278,115,0.626,8,0.673,8.2,2019-20
19,203460,Andre Roberson,1610612760,OKC,7,3,4,87.0,7,5,2,0.714,13,0.538,1,0.583,7.9,20,7,13,0.35,28,0.714,2,0.769,5.4,27,12,15,0.444,40,0.675,3,0.73,6.1,2019-20
20,203952,Andrew Wiggins,1610612744,GSW,54,15,39,1859.0,66,45,20,0.682,169,0.391,1,0.393,7.5,208,43,166,0.207,355,0.586,32,0.644,6.6,274,88,186,0.321,517,0.53,33,0.566,6.8,2019-20
21,1629014,Anfernee Simons,1610612757,POR,70,32,38,1449.0,25,7,18,0.28,73,0.342,2,0.352,14.9,127,22,107,0.173,204,0.623,18,0.683,7.9,152,29,125,0.191,272,0.559,20,0.603,9.0,2019-20
22,1627790,Ante Zizic,1610612739,CLE,22,4,18,221.0,18,13,4,0.722,44,0.409,0,0.409,5.2,48,20,28,0.417,79,0.608,7,0.667,4.4,66,33,32,0.5,118,0.559,7,0.595,4.6,2019-20
23,203076,Anthony Davis,1610612747,LAL,62,46,16,2131.0,142,104,36,0.732,302,0.47,10,0.486,5.5,435,140,295,0.322,663,0.656,43,0.702,5.4,577,244,331,0.423,945,0.611,53,0.647,5.4,2019-20
24,201229,Anthony Tolliver,1610612763,MEM,55,24,31,872.0,34,20,14,0.588,89,0.382,3,0.395,6.6,120,31,87,0.258,217,0.553,22,0.615,5.9,154,51,101,0.331,293,0.526,25,0.575,6.0,2019-20
25,1628499,Antonius Cleveland,1610612742,DAL,11,6,5,46.0,2,1,1,0.5,6,0.333,0,0.333,10.8,5,0,4,0.0,9,0.556,3,0.833,6.3,7,1,5,0.143,14,0.5,3,0.636,7.8,2019-20
26,1628394,Anzejs Pasecniks,1610612764,WAS,27,9,18,437.0,42,29,13,0.69,104,0.404,1,0.408,5.0,65,27,38,0.415,108,0.602,5,0.631,4.7,107,56,51,0.523,201,0.532,6,0.549,4.8,2019-20
27,203382,Aron Baynes,1610612756,PHX,41,19,22,914.0,68,41,26,0.603,162,0.42,5,0.433,6.0,161,52,111,0.323,303,0.531,36,0.603,5.1,229,93,137,0.406,451,0.508,41,0.559,5.4,2019-20
28,203085,Austin Rivers,1610612745,HOU,68,43,25,1594.0,27,9,18,0.333,72,0.375,3,0.391,14.1,148,30,118,0.203,272,0.544,32,0.617,8.2,175,39,136,0.223,343,0.51,35,0.568,9.1,2019-20
29,202340,Avery Bradley,1610612747,LAL,49,36,13,1186.0,18,10,8,0.556,48,0.375,3,0.4,10.4,97,12,84,0.124,175,0.554,20,0.626,7.4,115,22,92,0.191,220,0.523,23,0.584,7.9,2019-20
30,1629168,BJ Johnson,1610612753,ORL,10,5,5,83.0,3,2,1,0.667,4,0.75,0,0.75,5.6,12,3,9,0.25,17,0.706,1,0.75,7.5,15,5,10,0.333,21,0.714,1,0.75,7.1,2019-20
31,1628389,Bam Adebayo,1610612748,MIA,71,44,27,2382.0,171,98,72,0.573,401,0.426,9,0.436,7.4,552,158,393,0.286,788,0.701,62,0.76,5.4,723,256,465,0.354,1136,0.636,71,0.679,5.9,2019-20
32,203463,Ben McLemore,1610612745,HOU,71,44,27,1619.0,21,5,16,0.238,75,0.28,5,0.3,15.5,136,25,110,0.184,267,0.509,33,0.581,7.0,157,30,126,0.191,339,0.463,38,0.522,8.1,2019-20
33,1627732,Ben Simmons,1610612755,PHI,57,35,22,2017.0,113,59,54,0.522,264,0.428,3,0.433,8.5,331,49,282,0.148,458,0.723,28,0.77,7.4,444,108,336,0.243,679,0.654,31,0.685,7.7,2019-20
34,202687,Bismack Biyombo,1610612766,CHA,52,18,34,1021.0,118,88,29,0.746,268,0.44,3,0.445,5.2,186,66,116,0.355,347,0.536,50,0.626,4.6,304,154,145,0.507,598,0.508,53,0.558,4.8,2019-20
35,201933,Blake Griffin,1610612765,DET,17,8,9,483.0,17,10,7,0.588,42,0.405,2,0.425,6.4,64,22,42,0.344,107,0.598,12,0.674,6.4,81,32,49,0.395,145,0.559,14,0.618,6.4,2019-20
36,1626246,Boban Marjanovic,1610612742,DAL,44,21,23,422.0,66,59,6,0.894,124,0.532,4,0.55,3.6,131,42,88,0.321,182,0.72,17,0.794,3.9,197,101,94,0.513,295,0.668,21,0.719,3.8,2019-20
37,1626171,Bobby Portis,1610612752,NYK,66,21,45,1393.0,80,47,32,0.588,228,0.351,11,0.369,6.6,258,73,184,0.283,380,0.679,34,0.746,5.2,338,120,216,0.355,564,0.599,45,0.651,5.5,2019-20
38,203992,Bogdan Bogdanovic,1610612758,SAC,60,29,31,1736.0,26,17,10,0.654,75,0.347,1,0.351,10.4,177,41,136,0.232,317,0.558,40,0.639,7.1,203,58,146,0.286,382,0.531,41,0.595,7.6,2019-20
39,202711,Bojan Bogdanovic,1610612762,UTA,63,41,22,2083.0,39,23,15,0.59,129,0.302,0,0.302,11.1,220,31,188,0.141,344,0.64,23,0.685,7.7,259,54,203,0.208,454,0.57,23,0.601,8.2,2019-20
40,1629626,Bol Bol,1610612743,DEN,7,2,5,87.0,5,5,0,1.0,8,0.625,0,0.625,3.8,14,4,10,0.286,21,0.667,3,0.778,3.4,19,9,10,0.474,29,0.655,3,0.731,3.5,2019-20
41,202954,Brad Wanamaker,1610612738,BOS,71,48,23,1369.0,22,7,15,0.318,65,0.338,5,0.367,13.8,122,14,107,0.115,201,0.607,24,0.689,8.5,144,21,122,0.146,265,0.543,29,0.61,9.3,2019-20
42,203078,Bradley Beal,1610612764,WAS,57,20,37,2053.0,52,21,32,0.404,128,0.406,2,0.413,11.3,190,42,150,0.221,320,0.594,22,0.638,8.6,242,63,182,0.26,440,0.55,24,0.582,9.2,2019-20
43,1629634,Brandon Clarke,1610612763,MEM,58,29,29,1300.0,92,62,29,0.674,201,0.458,4,0.467,5.5,253,70,183,0.277,431,0.587,40,0.647,5.6,345,132,212,0.383,610,0.566,44,0.61,5.6,2019-20
44,1629164,Brandon Goodwin,1610612737,ATL,34,13,21,430.0,11,8,3,0.727,39,0.282,1,0.289,9.6,61,9,52,0.148,107,0.57,12,0.642,7.9,72,17,55,0.236,143,0.503,13,0.554,8.2,2019-20
45,1627742,Brandon Ingram,1610612740,NOP,61,25,36,2062.0,50,30,21,0.6,151,0.331,7,0.347,8.6,325,92,231,0.283,510,0.637,42,0.694,5.6,375,122,252,0.325,627,0.598,49,0.649,6.0,2019-20
46,202688,Brandon Knight,1610612765,DET,25,4,21,462.0,4,0,4,0.0,13,0.308,1,0.333,14.9,37,5,32,0.135,66,0.561,8,0.638,7.5,41,5,36,0.122,78,0.526,9,0.594,8.2,2019-20
47,1628968,Brian Bowen II,1610612754,IND,6,5,1,31.0,1,0,1,0.0,2,0.5,0,0.5,0.6,6,1,5,0.167,7,0.857,0,0.857,3.5,7,1,6,0.143,9,0.778,0,0.778,3.1,2019-20
48,201572,Brook Lopez,1610612749,MIL,67,52,15,1792.0,58,35,23,0.603,124,0.468,4,0.483,8.9,252,95,154,0.377,466,0.541,63,0.625,5.8,310,130,177,0.419,572,0.542,67,0.614,6.4,2019-20
49,1628971,Bruce Brown,1610612765,DET,57,18,39,1612.0,59,29,30,0.492,156,0.378,8,0.399,6.7,213,43,172,0.202,371,0.574,38,0.64,6.7,272,72,202,0.265,519,0.524,46,0.575,6.7,2019-20
50,203998,Bruno Caboclo,1610612745,HOU,30,11,19,244.0,23,16,6,0.696,47,0.489,1,0.5,6.2,37,9,26,0.243,69,0.536,12,0.649,4.8,60,25,32,0.417,112,0.536,13,0.606,5.3,2019-20
51,1628981,Bruno Fernando,1610612737,ATL,56,18,38,713.0,67,48,19,0.716,179,0.374,8,0.392,4.2,131,40,91,0.305,226,0.58,20,0.636,4.5,198,88,110,0.444,392,0.505,28,0.544,4.4,2019-20
52,1627854,Bryn Forbes,1610612759,SAS,62,26,36,1563.0,11,1,10,0.091,32,0.344,0,0.344,19.7,112,13,99,0.116,203,0.552,23,0.622,10.8,123,14,109,0.114,232,0.53,23,0.589,11.6,2019-20
53,1627741,Buddy Hield,1610612758,SAC,71,31,40,2192.0,56,22,35,0.393,158,0.354,7,0.371,11.2,267,37,230,0.139,446,0.599,43,0.663,7.6,323,59,265,0.183,597,0.541,50,0.59,8.2,2019-20
54,203468,CJ McCollum,1610612757,POR,69,33,36,2518.0,46,22,24,0.478,135,0.341,2,0.346,10.2,247,36,212,0.146,387,0.638,27,0.686,9.1,293,58,236,0.198,506,0.579,29,0.614,9.2,2019-20
55,101139,CJ Miles,1610612764,WAS,10,4,6,161.0,4,3,1,0.75,8,0.5,0,0.5,8.5,8,1,7,0.125,16,0.5,2,0.571,6.1,12,4,8,0.333,24,0.5,2,0.545,6.9,2019-20
56,1628997,Caleb Martin,1610612766,CHA,18,6,12,317.0,10,9,1,0.9,17,0.588,0,0.588,8.9,28,4,22,0.143,46,0.609,8,0.737,7.2,38,13,23,0.342,63,0.603,8,0.691,7.7,2019-20
57,1628403,Caleb Swanigan,1610612757,POR,26,11,15,278.0,27,21,6,0.778,71,0.38,2,0.391,4.4,71,31,40,0.437,122,0.582,11,0.64,4.3,98,52,46,0.531,183,0.536,13,0.576,4.4,2019-20
58,1629629,Cam Reddish,1610612737,ATL,58,17,41,1551.0,35,12,24,0.343,93,0.376,2,0.385,13.6,181,29,151,0.16,267,0.678,16,0.721,8.1,216,41,175,0.19,354,0.61,18,0.643,9.0,2019-20
59,1629661,Cameron Johnson,1610612756,PHX,56,28,28,1223.0,49,24,24,0.49,89,0.551,3,0.57,9.8,134,27,108,0.201,227,0.59,23,0.657,7.3,183,51,132,0.279,309,0.592,26,0.647,8.0,2019-20
60,1626166,Cameron Payne,1610612756,PHX,8,8,0,183.0,4,3,1,0.75,9,0.444,1,0.5,12.2,27,2,25,0.074,42,0.643,4,0.711,8.1,31,5,26,0.161,49,0.633,5,0.705,8.7,2019-20
61,1627747,Caris LeVert,1610612751,BKN,45,21,24,1330.0,49,27,22,0.551,131,0.374,10,0.405,8.3,140,26,111,0.186,247,0.567,29,0.642,7.0,189,53,133,0.28,374,0.505,39,0.564,7.3,2019-20
62,2546,Carmelo Anthony,1610612757,POR,57,27,30,1869.0,71,49,22,0.69,162,0.438,2,0.444,7.2,291,73,218,0.251,434,0.671,31,0.722,5.9,362,122,240,0.337,575,0.63,33,0.668,6.2,2019-20
63,1629035,Carsen Edwards,1610612738,BOS,37,25,12,351.0,6,2,3,0.333,16,0.375,1,0.4,12.7,41,6,35,0.146,55,0.745,3,0.788,6.9,47,8,38,0.17,70,0.671,4,0.712,7.5,2019-20
64,1626224,Cedi Osman,1610612739,CLE,65,19,46,1910.0,39,19,20,0.487,101,0.386,3,0.398,11.0,192,31,162,0.161,286,0.671,28,0.744,6.9,231,50,182,0.216,373,0.619,31,0.675,7.6,2019-20
65,1628990,Chandler Hutchison,1610612741,CHI,28,8,20,527.0,18,9,9,0.5,57,0.316,3,0.333,9.7,90,20,68,0.222,119,0.756,7,0.804,5.4,108,29,77,0.269,163,0.663,10,0.706,6.2,2019-20
66,202718,Chandler Parsons,1610612737,ATL,5,0,5,54.0,1,1,0,1.0,4,0.25,0,0.25,4.6,6,0,6,0.0,9,0.667,1,0.75,6.1,7,1,6,0.143,11,0.636,1,0.7,5.9,2019-20
67,1629718,Charlie Brown Jr.,1610612737,ATL,10,1,9,40.0,2,1,0,0.5,3,0.667,1,1.0,2.5,2,0,2,0.0,6,0.333,1,0.4,9.7,4,1,2,0.25,8,0.5,2,0.667,7.3,2019-20
68,1626184,Chasson Randle,1610612744,GSW,3,2,1,40.0,0,0,0,0.0,0,0.0,0,0.0,0.0,2,0,2,0.0,2,1.0,0,1.0,7.2,2,0,2,0.0,2,1.0,0,1.0,7.2,2019-20
69,1627767,Cheick Diallo,1610612756,PHX,47,20,27,479.0,30,21,10,0.7,90,0.333,2,0.341,5.9,101,35,63,0.347,161,0.627,13,0.682,4.1,131,56,73,0.427,242,0.541,15,0.577,4.6,2019-20
70,1629002,Chimezie Metu,1610612759,SAS,18,8,10,105.0,12,8,3,0.667,23,0.522,2,0.571,5.6,21,8,13,0.381,30,0.7,2,0.75,4.2,33,16,16,0.485,49,0.673,4,0.733,4.7,2019-20
71,1628449,Chris Boucher,1610612761,TOR,62,45,17,819.0,107,77,29,0.72,223,0.48,10,0.502,5.0,170,58,111,0.341,292,0.582,29,0.646,3.9,277,135,140,0.487,495,0.56,39,0.607,4.3,2019-20
72,1629185,Chris Chiozza,1610612751,BKN,28,14,14,401.0,9,2,7,0.222,23,0.391,2,0.429,14.4,44,4,40,0.091,81,0.543,7,0.595,10.2,53,6,47,0.113,103,0.515,9,0.564,10.9,2019-20
73,1629598,Chris Clemons,1610612745,HOU,33,19,14,291.0,4,1,3,0.25,7,0.571,0,0.571,16.0,26,4,22,0.154,46,0.565,5,0.634,6.4,30,5,25,0.167,53,0.566,5,0.625,7.7,2019-20
74,101108,Chris Paul,1610612760,OKC,70,44,26,2208.0,26,8,18,0.308,71,0.366,2,0.377,11.7,323,41,285,0.127,510,0.633,43,0.692,7.9,349,49,303,0.14,574,0.608,45,0.66,8.2,2019-20
75,1629735,Chris Silva,1610612748,MIA,43,27,16,334.0,58,42,16,0.724,130,0.446,4,0.46,4.8,64,19,44,0.297,137,0.467,23,0.561,4.2,122,61,60,0.5,257,0.475,27,0.53,4.5,2019-20
76,1626174,Christian Wood,1610612765,DET,61,20,41,1311.0,103,78,24,0.757,217,0.475,9,0.495,5.2,279,82,197,0.294,462,0.604,55,0.686,4.9,382,160,221,0.419,650,0.588,64,0.652,5.0,2019-20
77,203991,Clint Capela,1610612737,ATL,39,22,17,1279.0,168,128,41,0.762,346,0.486,8,0.497,5.7,369,130,239,0.352,550,0.671,36,0.718,4.9,537,258,280,0.48,875,0.614,44,0.646,5.2,2019-20
78,1629632,Coby White,1610612741,CHI,65,22,43,1674.0,28,9,19,0.321,95,0.295,4,0.308,15.3,202,32,169,0.158,317,0.637,26,0.694,7.0,230,41,188,0.178,405,0.568,30,0.613,8.0,2019-20
79,1628998,Cody Martin,1610612766,CHA,48,16,32,903.0,38,15,23,0.395,80,0.475,3,0.494,10.0,120,25,95,0.208,178,0.674,9,0.71,7.2,158,40,118,0.253,254,0.622,12,0.653,7.8,2019-20
80,203469,Cody Zeller,1610612766,CHA,57,18,39,1320.0,160,120,40,0.75,386,0.415,11,0.427,4.8,249,83,166,0.333,441,0.565,47,0.632,4.5,409,203,206,0.496,809,0.506,58,0.545,4.6,2019-20
81,1629012,Collin Sexton,1610612739,CLE,65,19,46,2143.0,61,26,34,0.426,191,0.319,13,0.343,10.7,143,17,126,0.119,233,0.614,21,0.675,10.7,204,43,160,0.211,423,0.482,34,0.524,10.7,2019-20
82,201147,Corey Brewer,1610612758,SAC,5,2,3,33.0,2,0,2,0.0,4,0.5,0,0.5,12.8,6,1,5,0.167,7,0.857,0,0.857,8.8,8,1,7,0.125,11,0.727,0,0.727,9.8,2019-20
83,202709,Cory Joseph,1610612758,SAC,71,31,40,1742.0,44,16,28,0.364,99,0.444,4,0.463,12.6,141,19,122,0.135,265,0.532,30,0.6,8.7,185,35,150,0.189,360,0.514,34,0.567,9.6,2019-20
84,201584,Courtney Lee,1610612742,DAL,23,14,9,334.0,6,1,5,0.167,12,0.5,0,0.5,17.8,25,2,22,0.08,34,0.735,4,0.833,8.9,31,3,27,0.097,46,0.674,4,0.738,10.7,2019-20
85,1626245,Cristiano Felicio,1610612741,CHI,22,6,16,386.0,55,37,17,0.673,100,0.55,5,0.579,5.6,47,14,34,0.298,93,0.505,10,0.566,5.1,102,51,51,0.5,189,0.54,15,0.586,5.4,2019-20
86,1626156,D'Angelo Russell,1610612750,MIN,45,11,34,1452.0,17,7,8,0.412,54,0.315,6,0.354,10.9,160,17,143,0.106,244,0.656,25,0.731,7.9,177,24,151,0.136,296,0.598,31,0.668,8.1,2019-20
87,201571,D.J. Augustin,1610612753,ORL,57,28,29,1420.0,22,8,14,0.364,66,0.333,2,0.344,14.7,100,12,90,0.12,168,0.595,20,0.676,10.9,122,20,104,0.164,232,0.526,22,0.581,11.7,2019-20
88,1628391,D.J. Wilson,1610612749,MIL,37,29,8,363.0,12,6,5,0.5,32,0.375,1,0.387,9.1,80,19,59,0.238,116,0.69,9,0.748,5.1,92,25,64,0.272,143,0.643,10,0.692,5.6,2019-20
89,1629610,DaQuan Jeffries,1610612758,SAC,13,4,9,141.0,3,1,2,0.333,3,1.0,0,1.0,10.7,15,6,9,0.4,26,0.577,5,0.714,8.7,18,7,11,0.389,29,0.621,5,0.75,9.0,2019-20
90,1627745,Damian Jones,1610612737,ATL,55,15,40,887.0,74,56,18,0.757,202,0.366,2,0.37,5.2,132,41,91,0.311,258,0.512,30,0.579,5.0,206,97,109,0.471,439,0.469,32,0.506,5.0,2019-20
91,203081,Damian Lillard,1610612757,POR,65,32,33,2436.0,32,13,18,0.406,131,0.244,7,0.258,9.5,248,39,209,0.157,418,0.593,42,0.66,8.8,280,52,227,0.186,546,0.513,49,0.563,8.8,2019-20
92,1627814,Damion Lee,1610612744,GSW,49,12,37,1423.0,32,9,23,0.281,79,0.405,3,0.421,11.5,207,39,168,0.188,332,0.623,34,0.695,7.3,239,48,191,0.201,407,0.587,37,0.646,7.8,2019-20
93,1628422,Damyean Dotson,1610612752,NYK,48,14,34,836.0,10,0,10,0.0,17,0.588,1,0.625,17.3,81,9,72,0.111,125,0.648,8,0.692,6.1,91,9,82,0.099,140,0.65,9,0.695,7.3,2019-20
94,1629655,Daniel Gafford,1610612741,CHI,43,15,28,609.0,52,37,15,0.712,138,0.377,4,0.388,3.9,54,18,33,0.333,150,0.36,32,0.458,4.1,106,55,48,0.519,287,0.369,36,0.422,4.0,2019-20
95,1628464,Daniel Theis,1610612738,BOS,65,42,23,1566.0,140,90,50,0.643,303,0.462,3,0.467,5.5,286,80,204,0.28,552,0.518,81,0.607,4.8,426,170,254,0.399,839,0.508,84,0.564,5.1,2019-20
96,201568,Danilo Gallinari,1610612760,OKC,62,37,25,1834.0,34,18,16,0.529,94,0.362,5,0.382,10.8,288,48,238,0.167,441,0.653,42,0.722,5.8,322,66,254,0.205,532,0.605,47,0.664,6.3,2019-20
97,201980,Danny Green,1610612747,LAL,68,51,17,1687.0,51,20,31,0.392,134,0.381,5,0.395,10.7,174,39,135,0.224,301,0.578,43,0.674,6.3,225,59,166,0.262,424,0.531,48,0.598,7.3,2019-20
98,203957,Dante Exum,1610612739,CLE,35,10,25,486.0,12,3,10,0.25,29,0.414,1,0.429,12.4,55,7,49,0.127,80,0.688,8,0.764,7.5,67,10,59,0.149,105,0.638,9,0.698,8.4,2019-20
99,1627863,Danuel House Jr.,1610612745,HOU,63,40,23,1913.0,57,17,38,0.298,128,0.445,2,0.452,12.6,210,41,169,0.195,355,0.592,37,0.66,6.9,267,58,207,0.217,475,0.562,39,0.612,8.0,2019-20
100,203967,Dario Saric,1610612756,PHX,65,32,33,1594.0,99,62,37,0.626,257,0.385,10,0.401,6.7,290,85,206,0.293,492,0.589,49,0.655,4.3,389,147,243,0.378,722,0.539,59,0.587,4.9,2019-20
101,1629647,Darius Bazley,1610612760,OKC,61,36,25,1129.0,30,16,14,0.533,75,0.4,1,0.405,8.1,216,59,150,0.273,324,0.667,27,0.727,5.5,246,75,164,0.305,386,0.637,28,0.687,5.8,2019-20
102,1629636,Darius Garland,1610612739,CLE,59,17,42,1824.0,27,7,19,0.259,70,0.386,3,0.403,15.6,84,11,73,0.131,148,0.568,17,0.641,10.0,111,18,92,0.162,217,0.512,20,0.563,11.3,2019-20
103,1629133,Daryl Macon,1610612748,MIA,4,4,0,14.0,0,0,0,0.0,0,0.0,0,0.0,0.0,0,0,0,0.0,0,0.0,1,0.0,0.0,0,0,0,0.0,0,0.0,1,0.0,0.0,2019-20
104,1628021,David Nwaba,1610612745,HOU,20,8,12,268.0,8,3,3,0.375,24,0.333,1,0.348,6.8,37,8,24,0.216,53,0.698,5,0.771,7.0,45,11,27,0.244,76,0.592,6,0.643,7.0,2019-20
105,202722,Davis Bertans,1610612764,WAS,54,20,34,1583.0,35,14,21,0.4,91,0.385,3,0.398,9.1,210,56,140,0.267,309,0.68,30,0.753,6.8,245,70,161,0.286,377,0.65,33,0.712,7.2,2019-20
106,1628368,De'Aaron Fox,1610612758,SAC,50,20,30,1604.0,34,14,19,0.412,91,0.374,1,0.378,10.7,158,24,133,0.152,245,0.645,16,0.69,9.1,192,38,152,0.198,331,0.58,17,0.611,9.4,2019-20
107,1629631,De'Andre Hunter,1610612737,ATL,63,19,44,2018.0,44,23,21,0.523,127,0.346,2,0.352,9.9,242,72,170,0.298,408,0.593,32,0.644,6.5,286,95,191,0.332,520,0.55,34,0.588,7.0,2019-20
108,1629001,De'Anthony Melton,1610612763,MEM,60,27,33,1167.0,43,24,18,0.558,117,0.368,4,0.381,7.2,177,30,147,0.169,274,0.646,24,0.708,6.5,220,54,165,0.245,376,0.585,28,0.632,6.6,2019-20
109,201599,DeAndre Jordan,1610612751,BKN,56,27,29,1234.0,141,98,40,0.695,304,0.464,7,0.475,4.9,420,110,300,0.262,550,0.764,25,0.8,4.7,561,208,340,0.371,814,0.689,32,0.717,4.8,2019-20
110,1627761,DeAndre' Bembry,1610612737,ATL,43,10,33,915.0,34,17,17,0.5,84,0.405,3,0.42,10.6,118,27,91,0.229,203,0.581,24,0.659,6.7,152,44,108,0.289,285,0.533,27,0.589,7.6,2019-20
111,201942,DeMar DeRozan,1610612759,SAS,67,30,37,2282.0,42,19,23,0.452,150,0.28,10,0.3,9.6,327,50,279,0.153,474,0.69,24,0.727,7.7,369,69,302,0.187,591,0.624,34,0.662,7.9,2019-20
112,201960,DeMarre Carroll,1610612745,HOU,24,10,14,290.0,12,6,4,0.5,27,0.444,0,0.444,7.0,43,10,33,0.233,71,0.606,10,0.705,6.6,55,16,37,0.291,95,0.579,10,0.647,6.7,2019-20
113,1629731,Dean Wade,1610612739,CLE,12,1,11,71.0,3,2,1,0.667,10,0.3,0,0.3,3.8,16,5,11,0.313,24,0.667,2,0.727,4.3,19,7,12,0.368,32,0.594,2,0.633,4.2,2019-20
114,1629028,Deandre Ayton,1610612756,PHX,38,20,18,1236.0,147,107,39,0.728,308,0.477,6,0.487,4.8,289,88,201,0.304,419,0.69,31,0.745,4.6,436,195,240,0.447,695,0.627,37,0.663,4.7,2019-20
115,1627749,Dejounte Murray,1610612759,SAS,65,28,37,1656.0,69,37,32,0.536,183,0.377,8,0.394,8.7,307,39,268,0.127,477,0.644,42,0.706,5.8,376,76,300,0.202,645,0.583,50,0.632,6.3,2019-20
116,1626153,Delon Wright,1610612742,DAL,72,41,31,1545.0,70,30,41,0.429,162,0.432,6,0.449,8.9,207,41,165,0.198,341,0.607,35,0.676,7.7,277,71,206,0.256,498,0.556,41,0.606,8.0,2019-20
117,203471,Dennis Schroder,1610612760,OKC,65,40,25,1999.0,19,6,13,0.316,77,0.247,4,0.26,14.6,217,18,197,0.083,330,0.658,24,0.709,10.3,236,24,210,0.102,403,0.586,28,0.629,10.6,2019-20
118,1628372,Dennis Smith Jr.,1610612752,NYK,34,7,27,537.0,21,9,13,0.429,39,0.538,1,0.553,11.2,57,12,45,0.211,86,0.663,7,0.722,7.5,78,21,58,0.269,125,0.624,8,0.667,8.5,2019-20
119,1627756,Denzel Valentine,1610612741,CHI,36,12,24,488.0,9,2,6,0.222,20,0.45,0,0.45,17.3,65,10,54,0.154,108,0.602,13,0.684,8.0,74,12,60,0.162,122,0.607,13,0.679,9.0,2019-20
120,1629126,Deonte Burton,1610612760,OKC,39,22,17,357.0,7,5,2,0.714,19,0.368,1,0.389,7.5,50,12,36,0.24,76,0.658,6,0.714,7.7,57,17,38,0.298,91,0.626,7,0.679,7.7,2019-20
121,202324,Derrick Favors,1610612740,NOP,50,24,26,1211.0,157,120,36,0.764,314,0.5,9,0.515,4.3,330,125,201,0.379,511,0.646,43,0.705,4.3,487,245,237,0.503,802,0.607,52,0.649,4.3,2019-20
122,1627884,Derrick Jones Jr.,1610612748,MIA,58,34,24,1350.0,65,38,26,0.585,135,0.481,3,0.492,8.1,165,53,112,0.321,246,0.671,21,0.733,6.7,230,91,138,0.396,367,0.627,24,0.671,7.1,2019-20
123,201565,Derrick Rose,1610612765,DET,49,17,32,1272.0,27,9,17,0.333,61,0.443,3,0.466,12.0,94,8,86,0.085,180,0.522,14,0.566,10.7,121,17,103,0.14,240,0.504,17,0.543,11.0,2019-20
124,1628476,Derrick Walton Jr.,1610612765,DET,26,15,11,248.0,2,0,2,0.0,3,0.667,0,0.667,10.2,14,2,12,0.143,26,0.538,2,0.583,9.7,16,2,14,0.125,29,0.552,2,0.593,9.7,2019-20
125,1628401,Derrick White,1610612759,SAS,67,31,36,1655.0,35,14,21,0.4,97,0.361,0,0.361,10.3,187,44,141,0.235,319,0.586,27,0.64,9.0,222,58,162,0.261,405,0.548,27,0.587,9.2,2019-20
126,1626164,Devin Booker,1610612756,PHX,70,34,36,2512.0,29,9,19,0.31,107,0.271,7,0.29,15.4,268,31,235,0.116,408,0.657,29,0.707,7.8,297,40,254,0.135,503,0.59,36,0.636,8.5,2019-20
127,1628985,Devon Hall,1610612760,OKC,11,6,5,81.0,2,1,1,0.5,5,0.4,0,0.4,6.7,5,1,4,0.2,7,0.714,4,1.667,6.8,7,2,5,0.286,12,0.583,4,0.875,6.8,2019-20
128,1629719,Devontae Cacok,1610612747,LAL,1,0,1,9.0,2,1,1,0.5,4,0.5,0,0.5,2.3,3,1,2,0.333,4,0.75,0,0.75,4.3,5,2,3,0.4,8,0.625,0,0.625,3.5,2019-20
129,1628984,Devonte' Graham,1610612766,CHA,62,23,39,2179.0,42,15,26,0.357,102,0.412,3,0.424,13.6,163,29,133,0.178,298,0.547,33,0.615,9.1,205,44,159,0.215,394,0.52,36,0.573,10.0,2019-20
130,1629608,Dewan Hernandez,1610612761,TOR,6,6,0,28.0,5,2,3,0.4,7,0.714,1,0.833,4.1,9,4,5,0.444,10,0.9,0,0.9,5.7,14,6,8,0.429,17,0.824,1,0.875,5.1,2019-20
131,203473,Dewayne Dedmon,1610612737,ATL,44,17,27,774.0,60,42,18,0.7,149,0.403,3,0.411,4.5,189,70,119,0.37,293,0.645,18,0.687,4.5,249,112,137,0.45,418,0.596,21,0.627,4.5,2019-20
132,1628415,Dillon Brooks,1610612763,MEM,73,34,39,2112.0,68,33,35,0.485,145,0.469,5,0.486,11.3,175,33,142,0.189,313,0.559,28,0.614,9.4,243,66,177,0.272,451,0.539,33,0.581,9.9,2019-20
133,203079,Dion Waiters,1610612747,LAL,10,4,6,207.0,2,1,1,0.5,6,0.333,0,0.333,12.2,22,3,19,0.136,36,0.611,3,0.667,9.4,24,4,20,0.167,42,0.571,3,0.615,9.7,2019-20
134,1627734,Domantas Sabonis,1610612754,IND,62,37,25,2159.0,189,154,36,0.815,432,0.438,13,0.451,4.0,582,153,428,0.263,879,0.662,58,0.709,3.9,771,307,464,0.398,1267,0.609,71,0.645,3.9,2019-20
135,1628378,Donovan Mitchell,1610612762,UTA,69,43,26,2364.0,53,26,24,0.491,115,0.461,4,0.477,11.0,251,49,203,0.195,391,0.642,29,0.693,8.4,304,75,227,0.247,503,0.604,33,0.647,8.8,2019-20
136,1629743,Donta Hall,1610612751,BKN,9,4,5,133.0,14,7,7,0.5,34,0.412,1,0.424,7.2,24,6,18,0.25,33,0.727,1,0.75,3.9,38,13,25,0.342,64,0.594,2,0.613,5.1,2019-20
137,1628978,Donte DiVincenzo,1610612749,MIL,65,52,13,1495.0,63,40,23,0.635,148,0.426,1,0.429,9.0,248,45,201,0.181,403,0.615,43,0.689,5.9,311,85,224,0.273,548,0.568,44,0.617,6.6,2019-20
138,1627827,Dorian Finney-Smith,1610612742,DAL,69,38,31,2079.0,143,84,57,0.587,280,0.511,18,0.546,7.7,257,74,181,0.288,423,0.608,52,0.693,6.3,400,158,238,0.395,688,0.581,70,0.647,6.8,2019-20
139,203926,Doug McDermott,1610612754,IND,69,43,26,1372.0,26,13,13,0.5,73,0.356,3,0.371,6.5,148,34,111,0.23,268,0.552,35,0.635,6.1,174,47,124,0.27,330,0.527,38,0.596,6.1,2019-20
140,1627733,Dragan Bender,1610612744,GSW,15,9,6,280.0,16,11,5,0.688,40,0.4,0,0.4,6.0,55,19,36,0.345,86,0.64,7,0.696,4.2,71,30,41,0.423,119,0.597,7,0.634,4.6,2019-20
141,203110,Draymond Green,1610612744,GSW,43,10,33,1222.0,23,13,11,0.565,78,0.295,2,0.303,9.4,243,86,157,0.354,378,0.643,38,0.715,5.7,266,99,168,0.372,432,0.616,40,0.679,6.0,2019-20
142,1629234,Drew Eubanks,1610612759,SAS,22,13,9,272.0,28,15,13,0.536,59,0.475,1,0.483,5.8,57,17,40,0.298,93,0.613,12,0.704,4.9,85,32,53,0.376,145,0.586,13,0.644,5.2,2019-20
143,1629130,Duncan Robinson,1610612748,MIA,72,44,28,2128.0,10,1,9,0.1,40,0.25,3,0.27,20.1,216,35,178,0.162,355,0.608,47,0.701,7.7,226,36,187,0.159,384,0.589,50,0.677,8.3,2019-20
144,1628605,Dusty Hannahs,1610612763,MEM,2,0,2,13.0,0,0,0,0.0,0,0.0,0,0.0,0.0,1,0,1,0.0,1,1.0,0,1.0,3.0,1,0,1,0.0,1,1.0,0,1.0,3.0,2019-20
145,1628407,Dwayne Bacon,1610612766,CHA,39,10,29,687.0,15,10,5,0.667,47,0.319,1,0.326,6.1,85,13,73,0.153,131,0.649,10,0.702,6.4,100,23,78,0.23,169,0.592,11,0.633,6.4,2019-20
146,2730,Dwight Howard,1610612747,LAL,69,52,17,1306.0,172,125,45,0.727,374,0.46,6,0.467,4.2,335,88,249,0.263,546,0.614,46,0.67,4.1,507,213,294,0.42,882,0.575,52,0.611,4.1,2019-20
147,203939,Dwight Powell,1610612742,DAL,39,24,15,1029.0,73,44,29,0.603,183,0.399,8,0.417,6.8,144,38,107,0.264,250,0.576,18,0.621,6.2,217,82,136,0.378,423,0.513,26,0.547,6.4,2019-20
148,1629058,Dzanan Musa,1610612751,BKN,40,20,20,487.0,21,12,9,0.571,54,0.389,3,0.412,8.6,65,8,56,0.123,99,0.657,9,0.722,7.3,86,20,65,0.233,153,0.562,12,0.61,7.6,2019-20
149,202734,E'Twaun Moore,1610612740,NOP,55,27,28,1004.0,31,14,15,0.452,63,0.492,2,0.508,9.0,100,18,80,0.18,148,0.676,9,0.719,9.4,131,32,95,0.244,203,0.645,11,0.682,9.3,2019-20
150,202334,Ed Davis,1610612762,UTA,28,16,12,303.0,35,21,12,0.6,89,0.393,3,0.407,6.1,70,20,49,0.286,117,0.598,7,0.636,4.5,105,41,61,0.39,197,0.533,10,0.561,5.0,2019-20
151,1628410,Edmond Sumner,1610612754,IND,31,16,15,447.0,11,6,5,0.545,23,0.478,0,0.478,10.2,35,5,29,0.143,67,0.522,9,0.603,10.8,46,11,34,0.239,90,0.511,9,0.568,10.6,2019-20
152,203901,Elfrid Payton,1610612752,NYK,45,17,28,1246.0,52,22,27,0.423,96,0.542,5,0.571,10.2,160,23,138,0.144,241,0.664,15,0.708,7.8,212,45,165,0.212,336,0.631,20,0.671,8.3,2019-20
153,1629059,Elie Okobo,1610612756,PHX,54,23,31,703.0,16,9,7,0.563,28,0.571,0,0.571,12.7,73,10,63,0.137,113,0.646,6,0.682,8.4,89,19,70,0.213,139,0.64,6,0.669,9.2,2019-20
154,1626144,Emmanuel Mudiay,1610612762,UTA,54,34,20,850.0,18,6,12,0.333,47,0.383,1,0.391,14.8,108,11,96,0.102,177,0.61,16,0.671,7.9,126,17,108,0.135,223,0.565,17,0.612,8.9,2019-20
155,202683,Enes Kanter,1610612738,BOS,58,36,22,983.0,163,139,23,0.853,364,0.448,7,0.457,3.2,268,76,191,0.284,434,0.618,40,0.68,4.5,431,215,214,0.499,774,0.557,47,0.593,4.0,2019-20
156,202339,Eric Bledsoe,1610612749,MIL,60,47,13,1615.0,42,27,17,0.643,127,0.331,5,0.344,9.6,237,39,200,0.165,368,0.644,33,0.707,8.3,279,66,217,0.237,484,0.576,38,0.626,8.5,2019-20
157,201569,Eric Gordon,1610612745,HOU,36,21,15,1016.0,9,0,8,0.0,42,0.214,4,0.237,27.6,62,13,49,0.21,114,0.544,8,0.585,10.5,71,13,57,0.183,152,0.467,12,0.507,12.5,2019-20
158,1628450,Eric Mika,1610612758,SAC,1,0,1,19.0,2,1,1,0.5,6,0.333,1,0.4,1.8,5,2,3,0.4,7,0.714,1,0.833,5.0,7,3,4,0.429,13,0.538,2,0.636,4.1,2019-20
159,1629672,Eric Paschall,1610612744,GSW,60,14,46,1654.0,82,51,30,0.622,185,0.443,9,0.466,7.5,193,49,143,0.254,306,0.631,19,0.672,7.0,275,100,173,0.364,480,0.573,28,0.608,7.1,2019-20
160,101141,Ersan Ilyasova,1610612749,MIL,62,47,15,971.0,62,47,14,0.758,155,0.4,6,0.416,5.6,237,63,173,0.266,341,0.695,28,0.757,4.9,299,110,187,0.368,469,0.638,34,0.687,5.0,2019-20
161,203095,Evan Fournier,1610612753,ORL,66,28,38,2076.0,18,5,12,0.278,59,0.305,1,0.31,18.3,153,27,127,0.176,253,0.605,23,0.665,9.4,171,32,139,0.187,304,0.563,24,0.611,10.3,2019-20
162,202323,Evan Turner,1610612750,MIN,19,3,16,251.0,8,2,6,0.25,19,0.421,0,0.421,11.6,30,9,20,0.3,52,0.577,10,0.714,7.1,38,11,26,0.289,69,0.551,10,0.644,8.1,2019-20
163,1628402,Frank Jackson,1610612740,NOP,58,26,32,776.0,22,5,17,0.227,43,0.512,2,0.537,13.6,59,12,47,0.203,91,0.648,7,0.702,7.1,81,17,64,0.21,133,0.609,9,0.653,8.9,2019-20
164,1626163,Frank Kaminsky,1610612756,PHX,38,19,19,745.0,34,25,7,0.735,91,0.374,4,0.391,5.1,135,56,79,0.415,220,0.614,24,0.689,4.5,169,81,86,0.479,298,0.567,28,0.626,4.6,2019-20
165,1628412,Frank Mason,1610612749,MIL,9,6,3,118.0,5,3,2,0.6,11,0.455,0,0.455,9.2,14,3,11,0.214,20,0.7,2,0.778,9.5,19,6,13,0.316,31,0.613,2,0.655,9.4,2019-20
166,1628373,Frank Ntilikina,1610612752,NYK,57,19,38,1187.0,23,8,14,0.348,41,0.561,3,0.605,15.6,98,19,79,0.194,173,0.566,19,0.636,9.7,121,27,93,0.223,207,0.585,22,0.654,10.8,2019-20
167,1627832,Fred VanVleet,1610612761,TOR,54,40,14,1928.0,18,4,15,0.222,84,0.214,4,0.225,15.4,185,29,155,0.157,305,0.607,19,0.647,9.5,203,33,170,0.163,387,0.525,23,0.558,10.1,2019-20
168,1627788,Furkan Korkmaz,1610612755,PHI,72,42,30,1559.0,18,9,9,0.5,46,0.391,4,0.429,12.4,150,19,131,0.127,211,0.711,17,0.773,8.9,168,28,140,0.167,251,0.669,21,0.73,9.3,2019-20
169,1629216,Gabe Vincent,1610612748,MIA,9,5,4,83.0,0,0,0,0.0,3,0.0,0,0.0,0.0,5,1,3,0.2,8,0.625,2,0.833,8.5,5,1,3,0.2,10,0.5,2,0.625,8.5,2019-20
170,202066,Garrett Temple,1610612751,BKN,62,30,32,1730.0,29,13,14,0.448,99,0.293,3,0.302,13.4,189,27,157,0.143,319,0.592,36,0.668,8.6,218,40,171,0.183,405,0.538,39,0.596,9.2,2019-20
171,1629726,Garrison Mathews,1610612764,WAS,18,8,10,227.0,6,3,3,0.5,11,0.545,0,0.545,11.2,18,4,14,0.222,29,0.621,2,0.667,8.2,24,7,17,0.292,40,0.6,2,0.632,9.0,2019-20
172,1629109,Gary Clark,1610612753,ORL,42,23,19,566.0,37,15,22,0.405,77,0.481,1,0.487,9.5,73,20,53,0.274,126,0.579,10,0.629,6.2,110,35,75,0.318,197,0.558,11,0.591,7.3,2019-20
173,203914,Gary Harris,1610612743,DEN,56,37,19,1780.0,26,12,13,0.462,82,0.317,4,0.333,11.9,137,27,107,0.197,198,0.692,10,0.729,10.0,163,39,120,0.239,277,0.588,14,0.62,10.3,2019-20
174,1627780,Gary Payton II,1610612764,WAS,29,13,16,432.0,26,19,7,0.731,53,0.491,2,0.51,6.2,54,11,43,0.204,91,0.593,9,0.659,4.8,80,30,50,0.375,143,0.559,11,0.606,5.3,2019-20
175,1629018,Gary Trent Jr.,1610612757,POR,60,28,32,1299.0,24,5,18,0.208,44,0.545,4,0.6,13.4,72,8,62,0.111,137,0.526,19,0.61,8.6,96,13,80,0.135,178,0.539,23,0.619,9.8,2019-20
176,201588,George Hill,1610612749,MIL,58,46,12,1247.0,50,22,26,0.44,95,0.526,4,0.549,8.0,124,28,95,0.226,198,0.626,14,0.674,8.6,174,50,121,0.287,292,0.596,18,0.635,8.4,2019-20
177,1627777,Georges Niang,1610612762,UTA,66,41,25,923.0,15,4,11,0.267,37,0.405,4,0.455,16.6,112,28,83,0.25,180,0.622,17,0.687,6.4,127,32,94,0.252,207,0.614,21,0.683,7.6,2019-20
178,203507,Giannis Antetokounmpo,1610612749,MIL,62,50,12,1885.0,136,97,39,0.713,314,0.433,7,0.443,5.8,704,164,541,0.233,976,0.721,63,0.771,4.8,840,261,580,0.311,1238,0.679,70,0.719,4.9,2019-20
179,203922,Glenn Robinson III,1610612755,PHI,62,17,45,1786.0,81,40,40,0.494,195,0.415,7,0.431,9.5,189,35,153,0.185,331,0.571,42,0.654,7.7,270,75,193,0.278,504,0.536,49,0.593,8.2,2019-20
180,1629048,Goga Bitadze,1610612754,IND,54,32,22,471.0,25,15,8,0.6,62,0.403,0,0.403,4.0,81,28,52,0.346,154,0.526,18,0.596,4.4,106,43,60,0.406,209,0.507,18,0.555,4.3,2019-20
181,201609,Goran Dragic,1610612748,MIA,58,37,21,1632.0,28,9,19,0.321,78,0.359,10,0.412,12.6,155,22,132,0.142,256,0.605,23,0.665,8.9,183,31,151,0.169,330,0.555,33,0.616,9.5,2019-20
182,202330,Gordon Hayward,1610612738,BOS,52,34,18,1740.0,55,24,31,0.436,146,0.377,3,0.385,8.3,293,54,239,0.184,417,0.703,29,0.755,7.0,348,78,270,0.224,535,0.65,32,0.692,7.3,2019-20
183,203476,Gorgui Dieng,1610612763,MEM,63,20,43,1096.0,91,48,42,0.527,196,0.464,4,0.474,6.7,263,78,182,0.297,398,0.661,31,0.717,5.1,354,126,224,0.356,570,0.621,35,0.662,5.5,2019-20
184,1629684,Grant Williams,1610612738,BOS,69,47,22,1043.0,59,40,19,0.678,158,0.373,4,0.383,5.8,119,42,75,0.353,224,0.531,31,0.617,6.1,178,82,94,0.461,373,0.477,35,0.527,6.0,2019-20
185,1628960,Grayson Allen,1610612763,MEM,38,16,22,718.0,8,2,6,0.25,34,0.235,3,0.258,20.9,77,10,67,0.13,122,0.631,10,0.688,8.6,85,12,73,0.141,153,0.556,13,0.607,9.8,2019-20
186,1628977,Hamidou Diallo,1610612760,OKC,46,25,21,896.0,44,26,14,0.591,90,0.489,1,0.494,5.7,123,25,91,0.203,190,0.647,20,0.724,5.7,167,51,105,0.305,271,0.616,21,0.668,5.7,2019-20
187,203084,Harrison Barnes,1610612758,SAC,71,31,40,2448.0,74,41,33,0.554,189,0.392,12,0.418,8.9,276,53,223,0.192,458,0.603,39,0.659,6.7,350,94,256,0.269,634,0.552,51,0.6,7.1,2019-20
188,1628385,Harry Giles III,1610612758,SAC,45,22,23,653.0,43,24,19,0.558,110,0.391,3,0.402,6.6,142,45,97,0.317,229,0.62,26,0.7,4.8,185,69,116,0.373,317,0.584,29,0.642,5.2,2019-20
189,202355,Hassan Whiteside,1610612757,POR,66,33,33,1973.0,255,202,52,0.792,511,0.499,8,0.507,4.5,633,230,400,0.363,987,0.641,79,0.697,3.9,888,432,452,0.486,1456,0.61,87,0.649,4.0,2019-20
190,1627740,Henry Ellenson,1610612751,BKN,5,2,3,15.0,2,1,1,0.5,4,0.5,0,0.5,3.9,4,1,3,0.25,7,0.571,2,0.8,4.0,6,2,4,0.333,11,0.545,2,0.667,4.0,2019-20
191,101133,Ian Mahinmi,1610612764,WAS,38,15,23,808.0,78,51,28,0.654,172,0.453,7,0.473,5.9,140,42,98,0.3,266,0.526,35,0.606,5.2,218,93,126,0.427,420,0.519,42,0.577,5.4,2019-20
192,1629649,Ignas Brazdeikis,1610612752,NYK,9,1,8,53.0,2,0,2,0.0,5,0.4,0,0.4,9.0,3,1,2,0.333,3,1.0,0,1.0,8.7,5,1,4,0.2,7,0.714,0,0.714,8.8,2019-20
193,202697,Iman Shumpert,1610612751,BKN,13,9,4,241.0,9,4,5,0.444,18,0.5,2,0.563,14.3,25,2,23,0.08,51,0.49,3,0.521,7.8,34,6,28,0.176,67,0.507,5,0.548,9.5,2019-20
194,1629067,Isaac Bonga,1610612764,WAS,66,22,44,1250.0,71,45,25,0.634,168,0.423,6,0.438,7.5,151,34,118,0.225,285,0.53,33,0.599,6.7,222,79,143,0.356,439,0.506,39,0.555,6.9,2019-20
195,1628392,Isaiah Hartenstein,1610612745,HOU,23,16,7,266.0,29,21,8,0.724,63,0.46,3,0.483,5.1,61,19,42,0.311,93,0.656,10,0.735,5.2,90,40,50,0.444,152,0.592,13,0.647,5.1,2019-20
196,1629676,Isaiah Roby,1610612760,OKC,3,2,1,11.0,0,0,0,0.0,0,0.0,0,0.0,0.0,2,1,1,0.5,2,1.0,0,1.0,1.9,2,1,1,0.5,2,1.0,0,1.0,1.9,2019-20
197,202738,Isaiah Thomas,1610612764,WAS,40,14,26,925.0,11,4,7,0.364,29,0.379,0,0.379,12.7,57,5,50,0.088,79,0.722,4,0.76,10.5,68,9,57,0.132,107,0.636,4,0.66,10.9,2019-20
198,202397,Ish Smith,1610612764,WAS,68,23,45,1787.0,30,7,23,0.233,75,0.4,5,0.429,12.7,189,30,158,0.159,339,0.558,32,0.616,8.5,219,37,181,0.169,408,0.537,37,0.59,9.0,2019-20
199,1627826,Ivica Zubac,1610612746,LAC,72,49,23,1326.0,197,159,38,0.807,392,0.503,4,0.508,3.7,346,113,231,0.327,570,0.607,60,0.678,4.2,543,272,269,0.501,934,0.581,64,0.624,4.0,2019-20
200,200826,J.J. Barea,1610612742,DAL,29,15,14,450.0,10,1,9,0.1,19,0.526,0,0.526,16.4,43,2,41,0.047,65,0.662,7,0.741,10.7,53,3,50,0.057,82,0.646,7,0.707,11.8,2019-20
201,1629122,J.P. Macura,1610612739,CLE,1,1,0,1.0,0,0,0,0.0,0,0.0,0,0.0,0.0,0,0,0,0.0,0,0.0,0,0.0,0.0,0,0,0,0.0,0,0.0,0,0.0,0.0,2019-20
202,200755,JJ Redick,1610612740,NOP,60,26,34,1581.0,10,2,8,0.2,37,0.27,1,0.278,14.8,141,15,126,0.106,236,0.597,23,0.662,8.7,151,17,134,0.113,269,0.561,24,0.616,9.1,2019-20
203,2747,JR Smith,1610612747,LAL,6,2,4,79.0,0,0,0,0.0,0,0.0,0,0.0,0.0,5,1,4,0.2,9,0.556,1,0.625,7.3,5,1,4,0.2,9,0.556,1,0.625,7.3,2019-20
204,1629630,Ja Morant,1610612763,MEM,67,33,34,2074.0,51,26,23,0.51,190,0.268,10,0.283,9.9,208,29,180,0.139,363,0.573,41,0.646,7.9,259,55,203,0.212,547,0.473,51,0.522,8.3,2019-20
205,203960,JaKarr Sampson,1610612754,IND,34,21,13,471.0,20,14,6,0.7,58,0.345,2,0.357,8.0,68,24,43,0.353,121,0.562,14,0.636,4.8,88,38,49,0.432,172,0.512,16,0.564,5.5,2019-20
206,203210,JaMychal Green,1610612746,LAC,63,43,20,1307.0,77,52,25,0.675,192,0.401,8,0.418,7.7,311,78,233,0.251,477,0.652,28,0.693,4.6,388,130,258,0.335,634,0.612,36,0.649,5.2,2019-20
207,201580,JaVale McGee,1610612747,LAL,68,51,17,1130.0,125,88,37,0.704,266,0.47,6,0.481,4.5,265,86,179,0.325,435,0.609,30,0.654,4.4,390,174,216,0.446,677,0.576,36,0.608,4.4,2019-20
208,203953,Jabari Parker,1610612758,SAC,38,9,29,918.0,61,38,22,0.623,161,0.379,4,0.389,6.4,153,39,114,0.255,238,0.643,13,0.68,5.5,214,77,136,0.36,384,0.557,17,0.583,5.8,2019-20
209,1628980,Jacob Evans,1610612750,MIN,29,8,21,418.0,9,6,3,0.667,22,0.409,2,0.45,10.6,32,10,21,0.313,58,0.552,5,0.604,7.2,41,16,24,0.39,80,0.513,7,0.562,8.0,2019-20
210,203109,Jae Crowder,1610612748,MIA,64,29,35,1840.0,51,24,28,0.471,125,0.408,4,0.421,11.3,322,57,264,0.177,465,0.692,43,0.763,6.2,373,81,292,0.217,566,0.659,47,0.719,6.9,2019-20
211,1626143,Jahlil Okafor,1610612740,NOP,30,9,21,467.0,48,37,11,0.771,123,0.39,3,0.4,5.4,79,30,49,0.38,147,0.537,13,0.59,4.6,127,67,60,0.528,263,0.483,16,0.514,4.9,2019-20
212,1627774,Jake Layman,1610612750,MIN,23,11,12,505.0,17,9,8,0.529,42,0.405,3,0.436,9.7,40,8,32,0.2,71,0.563,8,0.635,8.3,57,17,40,0.298,110,0.518,11,0.576,8.7,2019-20
213,1627751,Jakob Poeltl,1610612759,SAS,65,29,36,1155.0,127,95,30,0.748,253,0.502,4,0.51,5.1,237,99,137,0.418,410,0.578,41,0.642,4.2,364,194,167,0.533,643,0.566,45,0.609,4.5,2019-20
214,1628973,Jalen Brunson,1610612742,DAL,56,33,23,1007.0,22,10,12,0.455,61,0.361,1,0.367,12.2,111,20,90,0.18,184,0.603,22,0.685,8.0,133,30,102,0.226,243,0.547,23,0.605,8.7,2019-20
215,1629665,Jalen Lecque,1610612756,PHX,5,2,3,32.0,0,0,0,0.0,0,0.0,0,0.0,0.0,2,2,0,1.0,2,1.0,1,2.0,4.2,2,2,0,1.0,2,1.0,1,2.0,4.2,2019-20
216,1629667,Jalen McDaniels,1610612766,CHA,16,7,9,293.0,15,10,4,0.667,28,0.536,1,0.556,5.9,50,8,42,0.16,78,0.641,7,0.704,5.4,65,18,46,0.277,103,0.631,8,0.684,5.5,2019-20
217,2037,Jamal Crawford,1610612751,BKN,1,1,0,6.0,0,0,0,0.0,0,0.0,0,0.0,0.0,0,0,0,0.0,0,0.0,1,0.0,0.0,0,0,0,0.0,0,0.0,1,0.0,0.0,2019-20
218,1627750,Jamal Murray,1610612743,DEN,59,38,21,1903.0,45,20,25,0.444,110,0.409,6,0.433,11.0,191,33,158,0.173,301,0.635,29,0.702,8.4,236,53,183,0.225,405,0.583,35,0.638,8.9,2019-20
219,203516,James Ennis III,1610612753,ORL,69,42,27,1266.0,71,47,22,0.662,194,0.366,6,0.378,5.9,174,21,147,0.121,271,0.642,34,0.734,6.0,245,68,169,0.278,455,0.538,40,0.59,6.0,2019-20
220,201935,James Harden,1610612745,HOU,68,43,25,2483.0,70,34,35,0.486,225,0.311,3,0.315,9.9,376,83,293,0.221,599,0.628,36,0.668,7.4,446,117,328,0.262,795,0.561,39,0.59,7.8,2019-20
221,201949,James Johnson,1610612750,MIN,32,14,18,620.0,25,14,11,0.56,52,0.481,0,0.481,7.5,93,19,73,0.204,152,0.612,15,0.679,6.1,118,33,84,0.28,193,0.611,15,0.663,6.4,2019-20
222,201162,Jared Dudley,1610612747,LAL,45,30,15,364.0,6,3,3,0.5,17,0.353,0,0.353,9.4,46,9,36,0.196,80,0.575,12,0.676,7.3,52,12,39,0.231,91,0.571,12,0.658,7.5,2019-20
223,1629607,Jared Harper,1610612752,NYK,3,1,2,8.0,0,0,0,0.0,0,0.0,0,0.0,0.0,0,0,0,0.0,0,0.0,0,0.0,0.0,0,0,0,0.0,0,0.0,0,0.0,0.0,2019-20
224,1628991,Jaren Jackson Jr.,1610612763,MEM,57,28,29,1622.0,55,36,19,0.655,150,0.367,6,0.382,7.5,207,86,120,0.415,380,0.545,32,0.595,6.2,262,122,139,0.466,520,0.504,38,0.544,6.5,2019-20
225,1629020,Jarred Vanderbilt,1610612750,MIN,11,6,5,47.0,3,3,0,1.0,9,0.333,1,0.375,3.2,6,0,5,0.0,9,0.667,1,0.75,6.4,9,3,5,0.333,17,0.529,2,0.6,5.2,2019-20
226,1629714,Jarrell Brantley,1610612762,UTA,9,3,6,96.0,2,1,1,0.5,4,0.5,0,0.5,7.2,18,5,10,0.278,27,0.667,1,0.692,5.7,20,6,11,0.3,30,0.667,1,0.69,5.9,2019-20
227,1628386,Jarrett Allen,1610612751,BKN,70,33,37,1852.0,216,162,52,0.75,482,0.448,14,0.462,5.0,455,138,314,0.303,707,0.644,64,0.708,4.5,671,300,366,0.447,1150,0.583,78,0.626,4.6,2019-20
228,1629633,Jarrett Culver,1610612750,MIN,63,19,44,1506.0,70,37,32,0.529,153,0.458,4,0.47,9.4,142,26,116,0.183,237,0.599,19,0.651,7.9,212,63,148,0.297,384,0.552,23,0.587,8.4,2019-20
229,1627784,Jarrod Uthoff,1610612764,WAS,7,4,3,53.0,2,1,1,0.5,8,0.25,0,0.25,3.1,4,0,4,0.0,10,0.4,2,0.5,5.2,6,1,5,0.167,17,0.353,2,0.4,4.5,2019-20
230,1629750,Javonte Green,1610612738,BOS,48,33,15,468.0,24,18,6,0.75,51,0.471,1,0.48,4.9,69,19,50,0.275,106,0.651,8,0.704,7.0,93,37,56,0.398,151,0.616,9,0.655,6.4,2019-20
231,1629637,Jaxson Hayes,1610612740,NOP,63,28,35,1076.0,97,72,27,0.742,202,0.48,2,0.485,5.0,162,61,101,0.377,327,0.495,43,0.57,5.0,259,133,128,0.514,509,0.509,45,0.558,5.0,2019-20
232,1627759,Jaylen Brown,1610612738,BOS,57,38,19,1934.0,62,33,29,0.532,161,0.385,8,0.405,10.9,302,64,238,0.212,505,0.598,42,0.652,6.0,364,97,267,0.266,645,0.564,50,0.612,6.8,2019-20
233,1629658,Jaylen Hoard,1610612757,POR,13,7,6,103.0,14,11,2,0.786,25,0.56,1,0.583,7.2,18,3,14,0.167,29,0.621,4,0.72,4.9,32,14,16,0.438,52,0.615,5,0.681,5.9,2019-20
234,1629669,Jaylen Nowell,1610612750,MIN,15,2,13,151.0,3,2,1,0.667,9,0.333,0,0.333,11.6,10,1,9,0.1,19,0.526,5,0.714,10.0,13,3,10,0.231,28,0.464,5,0.565,10.4,2019-20
235,1628369,Jayson Tatum,1610612738,BOS,66,46,20,2265.0,64,37,25,0.578,201,0.318,2,0.322,8.6,396,66,332,0.167,556,0.712,36,0.762,6.4,460,103,357,0.224,703,0.654,38,0.692,6.7,2019-20
236,201145,Jeff Green,1610612745,HOU,48,28,20,960.0,24,14,10,0.583,57,0.421,2,0.436,8.0,109,27,79,0.248,177,0.616,13,0.665,8.2,133,41,89,0.308,228,0.583,15,0.624,8.2,2019-20
237,201952,Jeff Teague,1610612737,ATL,59,22,37,1464.0,27,10,17,0.37,69,0.391,4,0.415,14.8,115,11,104,0.096,189,0.608,19,0.676,9.3,142,21,121,0.148,256,0.555,23,0.609,10.3,2019-20
238,203924,Jerami Grant,1610612743,DEN,71,45,26,1892.0,58,36,20,0.621,136,0.426,6,0.446,7.3,190,60,131,0.316,333,0.571,28,0.623,6.2,248,96,151,0.387,459,0.54,34,0.584,6.5,2019-20
239,1629725,Jeremiah Martin,1610612751,BKN,9,6,3,99.0,1,0,1,0.0,3,0.333,0,0.333,26.9,9,1,8,0.111,16,0.563,1,0.6,12.2,10,1,9,0.1,19,0.526,1,0.556,13.7,2019-20
240,203087,Jeremy Lamb,1610612754,IND,46,27,19,1291.0,24,10,14,0.417,62,0.387,3,0.407,7.4,176,36,140,0.205,278,0.633,30,0.71,6.2,200,46,154,0.23,334,0.599,33,0.664,6.3,2019-20
241,202951,Jeremy Pargo,1610612744,GSW,3,0,3,44.0,1,0,1,0.0,2,0.5,0,0.5,16.7,2,0,2,0.0,4,0.5,1,0.667,7.3,3,0,3,0.0,6,0.5,1,0.6,10.5,2019-20
242,1626170,Jerian Grant,1610612764,WAS,6,1,5,80.0,2,0,2,0.0,3,0.667,0,0.667,15.0,4,0,4,0.0,8,0.5,0,0.5,8.0,6,0,6,0.0,9,0.667,0,0.667,10.4,2019-20
243,1629010,Jerome Robinson,1610612764,WAS,63,36,27,979.0,13,2,11,0.154,37,0.351,1,0.361,13.9,116,13,100,0.112,181,0.641,15,0.699,7.0,129,15,111,0.116,216,0.597,16,0.645,7.7,2019-20
244,1628975,Jevon Carter,1610612756,PHX,58,29,29,945.0,30,8,22,0.267,64,0.469,2,0.484,15.1,88,12,74,0.136,134,0.657,16,0.746,8.6,118,20,96,0.169,188,0.628,18,0.694,10.3,2019-20
245,202710,Jimmy Butler,1610612748,MIA,58,38,20,1959.0,106,67,37,0.632,244,0.434,7,0.447,7.7,280,54,224,0.193,415,0.675,36,0.739,7.2,386,121,261,0.313,657,0.588,43,0.629,7.3,2019-20
246,201149,Joakim Noah,1610612746,LAC,5,4,1,50.0,5,4,1,0.8,12,0.417,0,0.417,4.2,11,2,9,0.182,22,0.5,3,0.579,5.0,16,6,10,0.375,30,0.533,3,0.593,4.7,2019-20
247,1629147,Joe Chealey,1610612766,CHA,4,1,3,33.0,0,0,0,0.0,0,0.0,0,0.0,0.0,0,0,0,0.0,0,0.0,0,0.0,0.0,0,0,0,0.0,0,0.0,0,0.0,0.0,2019-20
248,203925,Joe Harris,1610612751,BKN,69,33,36,2123.0,64,31,31,0.484,176,0.364,6,0.376,11.4,234,40,193,0.171,430,0.544,50,0.616,7.8,298,71,224,0.238,598,0.498,56,0.55,8.6,2019-20
249,204060,Joe Ingles,1610612762,UTA,72,44,28,2137.0,27,13,14,0.481,65,0.415,2,0.429,16.2,251,35,215,0.139,377,0.666,29,0.721,7.6,278,48,229,0.173,436,0.638,31,0.686,8.4,2019-20
250,203954,Joel Embiid,1610612755,PHI,51,32,19,1506.0,141,94,47,0.667,305,0.462,11,0.48,5.7,452,126,325,0.279,709,0.638,66,0.703,4.3,593,220,372,0.371,975,0.608,77,0.66,4.6,2019-20
251,1628381,John Collins,1610612737,ATL,41,15,26,1363.0,116,75,41,0.647,296,0.392,5,0.399,6.0,300,93,203,0.31,473,0.634,38,0.69,4.4,416,168,244,0.404,732,0.568,43,0.604,4.9,2019-20
252,203089,John Henson,1610612765,DET,40,8,32,600.0,46,32,14,0.696,108,0.426,1,0.43,5.6,116,41,75,0.353,187,0.62,26,0.72,4.5,162,73,89,0.451,285,0.568,27,0.628,4.8,2019-20
253,1629723,John Konchar,1610612763,MEM,19,9,10,181.0,18,10,8,0.556,31,0.581,0,0.581,7.9,29,8,21,0.276,40,0.725,4,0.806,6.1,47,18,29,0.383,71,0.662,4,0.701,6.8,2019-20
254,1628405,Johnathan Motley,1610612746,LAC,13,8,5,41.0,3,1,1,0.333,5,0.6,0,0.6,1.9,7,1,5,0.143,7,1.0,1,1.167,4.2,10,2,6,0.2,10,1.0,1,1.111,3.6,2019-20
255,1629140,Johnathan Williams,1610612764,WAS,15,7,8,180.0,24,16,7,0.667,52,0.462,3,0.49,5.0,40,11,28,0.275,60,0.667,6,0.741,4.9,64,27,35,0.422,110,0.582,9,0.634,4.9,2019-20
256,1628413,Jonah Bolden,1610612756,PHX,7,6,1,47.0,3,3,0,1.0,6,0.5,1,0.6,2.4,6,5,1,0.833,10,0.6,0,0.6,4.8,9,8,1,0.889,16,0.563,1,0.6,4.0,2019-20
257,202685,Jonas Valanciunas,1610612763,MEM,70,32,38,1845.0,213,166,46,0.779,469,0.454,10,0.464,4.3,575,190,384,0.33,900,0.639,81,0.702,4.0,788,356,430,0.452,1329,0.593,91,0.637,4.1,2019-20
258,1628371,Jonathan Isaac,1610612753,ORL,34,15,19,980.0,58,40,17,0.69,133,0.436,2,0.443,4.9,173,54,120,0.312,300,0.577,31,0.643,5.1,231,94,137,0.407,414,0.558,33,0.606,5.1,2019-20
259,1628395,Jordan Bell,1610612739,CLE,29,8,21,256.0,30,19,9,0.633,59,0.508,1,0.517,6.1,51,16,34,0.314,73,0.699,7,0.773,4.3,81,35,43,0.432,126,0.643,8,0.686,5.0,2019-20
260,1629648,Jordan Bone,1610612765,DET,10,3,7,53.0,0,0,0,0.0,0,0.0,0,0.0,0.0,4,0,1,0.0,1,4.0,0,4.0,11.3,4,0,1,0.0,1,4.0,0,4.0,11.3,2019-20
261,203903,Jordan Clarkson,1610612762,UTA,71,34,37,1705.0,50,23,27,0.46,114,0.439,6,0.463,9.8,137,23,114,0.168,246,0.557,27,0.626,8.2,187,46,141,0.246,356,0.525,33,0.579,8.7,2019-20
262,1629162,Jordan McLaughlin,1610612750,MIN,30,7,23,590.0,7,2,5,0.286,26,0.269,0,0.269,20.6,42,12,29,0.286,71,0.592,8,0.667,9.5,49,14,34,0.286,95,0.516,8,0.563,11.1,2019-20
263,203895,Jordan McRae,1610612765,DET,37,12,25,785.0,18,8,10,0.444,42,0.429,0,0.429,13.2,106,18,86,0.17,149,0.711,6,0.741,7.4,124,26,96,0.21,185,0.67,6,0.693,8.3,2019-20
264,1629673,Jordan Poole,1610612744,GSW,57,12,45,1274.0,9,3,6,0.333,45,0.2,1,0.205,16.4,109,12,96,0.11,167,0.653,12,0.703,9.0,118,15,102,0.127,207,0.57,13,0.608,9.5,2019-20
265,1627982,Josh Gray,1610612740,NOP,2,1,1,23.0,1,0,1,0.0,2,0.5,0,0.5,5.8,1,0,1,0.0,1,1.0,0,1.0,8.4,2,0,2,0.0,3,0.667,0,0.667,7.1,2019-20
266,1628404,Josh Hart,1610612740,NOP,64,26,38,1742.0,61,32,29,0.525,161,0.379,5,0.391,12.1,360,89,272,0.247,559,0.644,53,0.711,5.4,421,121,301,0.287,696,0.605,58,0.66,6.4,2019-20
267,1628367,Josh Jackson,1610612763,MEM,22,10,12,381.0,11,6,5,0.545,35,0.314,1,0.324,9.5,55,13,42,0.236,83,0.663,3,0.688,5.8,66,19,47,0.288,116,0.569,4,0.589,6.4,2019-20
268,203705,Josh Magette,1610612753,ORL,8,3,5,38.0,1,0,0,0.0,1,1.0,0,1.0,0.0,5,1,4,0.2,6,0.833,0,0.833,7.0,6,1,4,0.167,6,1.0,0,1.0,7.0,2019-20
269,1629006,Josh Okogie,1610612750,MIN,62,19,43,1547.0,87,55,31,0.632,185,0.47,10,0.497,7.9,181,41,140,0.227,266,0.68,10,0.707,7.9,268,96,171,0.358,447,0.6,20,0.628,7.9,2019-20
270,1629729,Josh Reaves,1610612742,DAL,4,2,2,28.0,1,1,0,1.0,3,0.333,0,0.333,3.6,2,1,1,0.5,3,0.667,1,1.0,6.0,3,2,1,0.667,6,0.5,1,0.6,5.2,2019-20
271,1626196,Josh Richardson,1610612755,PHI,55,33,22,1693.0,41,20,21,0.488,114,0.36,14,0.41,10.1,133,27,107,0.203,217,0.613,21,0.679,9.6,174,47,128,0.27,325,0.535,35,0.6,9.7,2019-20
272,201950,Jrue Holiday,1610612740,NOP,60,26,34,2080.0,75,36,40,0.48,181,0.414,7,0.431,9.1,212,36,176,0.17,361,0.587,35,0.65,8.6,287,72,216,0.251,531,0.54,42,0.587,8.7,2019-20
273,1629308,Juan Toscano-Anderson,1610612744,GSW,13,3,10,272.0,9,5,4,0.556,21,0.429,1,0.45,6.4,43,10,33,0.233,77,0.558,10,0.642,5.7,52,15,37,0.288,94,0.553,11,0.627,5.8,2019-20
274,1627823,Juancho Hernangomez,1610612750,MIN,48,24,24,834.0,43,28,11,0.651,120,0.358,2,0.364,5.1,154,38,109,0.247,227,0.678,17,0.733,5.0,197,66,120,0.335,327,0.602,19,0.64,5.0,2019-20
275,203944,Julius Randle,1610612752,NYK,64,21,43,2080.0,151,106,44,0.702,348,0.434,9,0.445,5.8,471,110,361,0.234,693,0.68,69,0.755,5.3,622,216,405,0.347,997,0.624,78,0.677,5.4,2019-20
276,1626147,Justin Anderson,1610612751,BKN,10,6,4,107.0,1,0,1,0.0,4,0.25,1,0.333,34.2,20,5,15,0.25,22,0.909,0,0.909,5.8,21,5,16,0.238,24,0.875,1,0.913,7.1,2019-20
277,203200,Justin Holiday,1610612754,IND,73,45,28,1826.0,32,9,23,0.281,82,0.39,0,0.39,13.6,206,50,155,0.243,346,0.595,31,0.654,7.3,238,59,178,0.248,413,0.576,31,0.623,8.2,2019-20
278,1628382,Justin Jackson,1610612742,DAL,64,38,26,1024.0,26,13,12,0.5,78,0.333,4,0.351,9.1,126,31,93,0.246,176,0.716,9,0.754,6.6,152,44,105,0.289,234,0.65,13,0.688,7.0,2019-20
279,1629713,Justin James,1610612758,SAC,36,14,22,232.0,6,4,2,0.667,15,0.4,3,0.5,9.9,26,5,21,0.192,44,0.591,5,0.667,4.7,32,9,23,0.281,54,0.593,8,0.696,5.7,2019-20
280,1628383,Justin Patton,1610612765,DET,5,2,3,24.0,1,1,0,1.0,3,0.333,0,0.333,4.7,4,3,1,0.75,5,0.8,0,0.8,5.2,5,4,1,0.8,7,0.714,0,0.714,5.1,2019-20
281,1629620,Justin Robinson,1610612764,WAS,9,2,7,49.0,1,0,0,0.0,0,0.0,0,0.0,0.0,4,0,2,0.0,5,0.8,0,0.8,13.9,5,0,2,0.0,5,1.0,0,1.0,13.9,2019-20
282,1629625,Justin Wright-Foreman,1610612762,UTA,4,1,3,45.0,0,0,0,0.0,1,0.0,0,0.0,0.0,5,1,4,0.2,6,0.833,0,0.833,12.5,5,1,4,0.2,6,0.833,0,0.833,12.5,2019-20
283,1626159,Justise Winslow,1610612763,MEM,11,7,4,352.0,16,9,7,0.563,33,0.485,1,0.5,10.7,57,13,44,0.228,89,0.64,11,0.731,5.4,73,22,51,0.301,120,0.608,12,0.676,6.6,2019-20
284,203994,Jusuf Nurkic,1610612757,POR,8,6,2,253.0,23,19,4,0.826,56,0.411,0,0.411,3.3,59,19,40,0.322,96,0.615,12,0.702,3.9,82,38,44,0.463,149,0.55,12,0.599,3.8,2019-20
285,1629752,Juwan Morgan,1610612762,UTA,21,12,9,134.0,10,8,2,0.8,26,0.385,0,0.385,5.4,19,9,10,0.474,33,0.576,2,0.613,6.3,29,17,12,0.586,56,0.518,2,0.537,6.0,2019-20
286,1629644,KZ Okpala,1610612748,MIA,5,2,3,26.0,1,1,0,1.0,4,0.25,0,0.25,1.3,4,1,2,0.25,3,1.333,0,1.333,5.8,5,2,2,0.4,7,0.714,0,0.714,4.7,2019-20
287,1628443,Kadeem Allen,1610612752,NYK,10,3,7,117.0,2,0,2,0.0,3,0.667,0,0.667,23.2,7,1,6,0.143,16,0.438,3,0.538,6.3,9,1,8,0.111,19,0.474,3,0.563,10.0,2019-20
288,1626157,Karl-Anthony Towns,1610612750,MIN,35,10,25,1187.0,95,76,16,0.8,206,0.461,4,0.47,5.6,283,104,179,0.367,418,0.677,25,0.72,4.7,378,180,195,0.476,603,0.627,29,0.659,4.9,2019-20
289,202695,Kawhi Leonard,1610612746,LAC,57,41,16,1848.0,54,27,25,0.5,163,0.331,3,0.338,8.7,348,86,262,0.247,490,0.71,34,0.763,6.7,402,113,287,0.281,614,0.655,37,0.697,6.9,2019-20
290,1628966,Keita Bates-Diop,1610612743,DEN,44,10,34,744.0,25,14,11,0.56,55,0.455,2,0.472,8.4,102,28,74,0.275,151,0.675,14,0.745,6.5,127,42,85,0.331,201,0.632,16,0.686,6.9,2019-20
291,1629103,Kelan Martin,1610612750,MIN,31,12,19,495.0,12,5,7,0.417,39,0.308,1,0.316,11.4,84,14,70,0.167,125,0.672,6,0.706,6.6,96,19,77,0.198,158,0.608,7,0.636,7.2,2019-20
292,1629640,Keldon Johnson,1610612759,SAS,17,8,9,301.0,10,6,4,0.6,30,0.333,2,0.357,6.8,47,12,35,0.255,79,0.595,5,0.635,7.6,57,18,39,0.316,104,0.548,7,0.588,7.5,2019-20
293,203482,Kelly Olynyk,1610612748,MIA,66,41,25,1287.0,44,29,15,0.659,156,0.282,5,0.291,7.2,258,59,198,0.229,451,0.572,52,0.647,5.1,302,88,213,0.291,569,0.531,57,0.59,5.4,2019-20
294,1626162,Kelly Oubre Jr.,1610612756,PHX,55,22,33,1893.0,67,39,28,0.582,179,0.374,4,0.383,8.0,286,50,236,0.175,440,0.65,30,0.698,5.6,353,89,264,0.252,587,0.601,34,0.638,6.1,2019-20
295,202689,Kemba Walker,1610612738,BOS,56,37,19,1742.0,36,21,14,0.583,98,0.367,3,0.379,9.3,181,36,145,0.199,335,0.54,34,0.601,7.9,217,57,159,0.263,432,0.502,37,0.549,8.2,2019-20
296,1629134,Kendrick Nunn,1610612748,MIA,66,42,24,1935.0,21,13,8,0.619,86,0.244,8,0.269,10.5,159,27,132,0.17,282,0.564,43,0.665,7.9,180,40,140,0.222,368,0.489,51,0.568,8.2,2019-20
297,1629026,Kenrich Williams,1610612740,NOP,39,12,27,832.0,51,31,19,0.608,127,0.402,11,0.44,7.3,135,29,105,0.215,221,0.611,19,0.668,5.6,186,60,124,0.323,334,0.557,30,0.612,6.1,2019-20
298,203145,Kent Bazemore,1610612758,SAC,67,32,35,1661.0,27,12,15,0.444,103,0.262,2,0.267,14.3,261,52,208,0.199,422,0.618,40,0.683,6.4,288,64,223,0.222,504,0.571,42,0.623,7.1,2019-20
299,203484,Kentavious Caldwell-Pope,1610612747,LAL,69,51,18,1762.0,38,14,23,0.368,68,0.559,2,0.576,12.8,104,24,78,0.231,209,0.498,26,0.568,8.6,142,38,101,0.268,270,0.526,28,0.587,9.7,2019-20
300,1628987,Kevin Hervey,1610612760,OKC,10,3,7,52.0,1,1,0,1.0,1,1.0,0,1.0,9.0,11,2,9,0.182,13,0.846,2,1.0,9.2,12,3,9,0.25,14,0.857,2,1.0,9.1,2019-20
301,1628989,Kevin Huerter,1610612737,ATL,56,19,37,1760.0,35,19,17,0.543,94,0.372,4,0.389,10.2,193,22,171,0.114,305,0.633,13,0.661,7.7,228,41,188,0.18,392,0.582,17,0.608,8.1,2019-20
302,1628995,Kevin Knox II,1610612752,NYK,65,21,44,1166.0,28,7,21,0.25,67,0.418,1,0.424,11.0,156,22,127,0.141,226,0.69,14,0.736,6.2,184,29,148,0.158,281,0.655,15,0.692,7.1,2019-20
303,201567,Kevin Love,1610612739,CLE,56,16,40,1780.0,54,35,18,0.648,163,0.331,8,0.348,6.2,493,149,344,0.302,703,0.701,43,0.747,4.3,547,184,362,0.336,840,0.651,51,0.693,4.5,2019-20
304,1629645,Kevin Porter Jr.,1610612739,CLE,50,15,35,1162.0,22,13,9,0.591,74,0.297,7,0.328,10.9,140,34,106,0.243,208,0.673,26,0.769,6.6,162,47,115,0.29,278,0.583,33,0.661,7.2,2019-20
305,1626172,Kevon Looney,1610612744,GSW,20,6,14,262.0,28,19,9,0.679,55,0.509,4,0.549,5.0,38,16,22,0.421,66,0.576,5,0.623,5.6,66,35,31,0.53,116,0.569,9,0.617,5.4,2019-20
306,203920,Khem Birch,1610612753,ORL,48,19,29,922.0,91,60,32,0.659,203,0.448,3,0.455,5.5,129,43,85,0.333,224,0.576,23,0.642,5.8,220,103,117,0.468,419,0.525,26,0.56,5.7,2019-20
307,203114,Khris Middleton,1610612749,MIL,61,45,16,1818.0,42,21,21,0.5,99,0.424,3,0.438,12.1,331,50,282,0.151,484,0.684,35,0.737,6.9,373,71,303,0.19,568,0.657,38,0.704,7.5,2019-20
308,1629017,Khyri Thomas,1610612765,DET,8,2,6,61.0,1,0,1,0.0,1,1.0,0,1.0,23.7,0,0,0,0.0,0,0.0,1,0.0,0.0,1,0,1,0.0,1,1.0,1,0.0,23.7,2019-20
309,1628961,Kostas Antetokounmpo,1610612747,LAL,5,3,2,20.0,2,1,1,0.5,2,1.0,0,1.0,4.7,1,0,0,0.0,1,1.0,0,1.0,0.0,3,1,1,0.333,3,1.0,0,1.0,4.7,2019-20
310,1627739,Kris Dunn,1610612741,CHI,51,19,32,1269.0,23,10,13,0.435,62,0.371,3,0.39,12.4,163,29,136,0.178,266,0.613,31,0.694,6.6,186,39,149,0.21,322,0.578,34,0.646,7.3,2019-20
311,204001,Kristaps Porzingis,1610612742,DAL,55,30,25,1739.0,95,57,39,0.6,203,0.468,1,0.47,7.5,425,134,290,0.315,627,0.678,59,0.748,4.6,520,191,329,0.367,797,0.652,60,0.706,5.2,2019-20
312,1629065,Ky Bowman,1610612744,GSW,45,9,36,1015.0,24,9,14,0.375,59,0.407,3,0.429,14.9,97,13,82,0.134,181,0.536,27,0.63,8.5,121,22,96,0.182,239,0.506,30,0.579,9.8,2019-20
313,1629734,Kyle Alexander,1610612748,MIA,2,0,2,13.0,2,1,1,0.5,4,0.5,0,0.5,3.2,1,0,1,0.0,6,0.167,1,0.2,3.8,3,1,2,0.333,9,0.333,1,0.375,3.4,2019-20
314,203937,Kyle Anderson,1610612763,MEM,67,32,35,1330.0,58,34,24,0.586,133,0.436,5,0.453,8.2,227,47,180,0.207,337,0.674,21,0.718,6.9,285,81,204,0.284,440,0.648,26,0.688,7.2,2019-20
315,1629657,Kyle Guy,1610612758,SAC,3,2,1,10.0,0,0,0,0.0,0,0.0,0,0.0,0.0,1,1,0,1.0,2,0.5,1,1.0,2.7,1,1,0,1.0,2,0.5,1,1.0,2.7,2019-20
316,2594,Kyle Korver,1610612749,MIL,57,42,15,942.0,14,3,11,0.214,26,0.538,4,0.636,18.3,103,18,85,0.175,182,0.566,17,0.624,7.7,117,21,96,0.179,204,0.574,21,0.639,8.9,2019-20
317,1628398,Kyle Kuzma,1610612747,LAL,61,46,15,1526.0,52,22,29,0.423,100,0.52,1,0.525,8.2,221,58,161,0.262,352,0.628,30,0.686,6.7,273,80,190,0.293,430,0.635,31,0.684,7.0,2019-20
318,200768,Kyle Lowry,1610612761,TOR,57,40,17,2063.0,32,10,22,0.313,128,0.25,4,0.258,13.1,255,48,207,0.188,475,0.537,49,0.599,7.8,287,58,229,0.202,598,0.48,53,0.527,8.4,2019-20
319,203124,Kyle O'Quinn,1610612755,PHI,29,18,11,313.0,34,22,11,0.647,66,0.515,1,0.523,6.3,82,24,55,0.293,130,0.631,9,0.678,4.9,116,46,66,0.397,186,0.624,10,0.659,5.3,2019-20
320,202681,Kyrie Irving,1610612751,BKN,20,8,12,658.0,22,10,12,0.455,46,0.478,2,0.5,10.6,81,7,74,0.086,128,0.633,9,0.681,8.6,103,17,86,0.165,174,0.592,11,0.632,9.0,2019-20
321,200746,LaMarcus Aldridge,1610612759,SAS,52,22,30,1717.0,101,67,35,0.663,210,0.481,4,0.49,5.9,284,79,204,0.278,486,0.584,51,0.653,6.4,385,146,239,0.379,680,0.566,55,0.616,6.3,2019-20
322,202498,Lance Thomas,1610612751,BKN,7,4,3,98.0,2,0,2,0.0,8,0.25,1,0.286,18.2,11,3,8,0.273,14,0.786,0,0.786,6.4,13,3,10,0.231,19,0.684,1,0.722,8.2,2019-20
323,1629013,Landry Shamet,1610612746,LAC,53,34,19,1452.0,6,5,1,0.833,29,0.207,1,0.214,6.8,94,13,81,0.138,158,0.595,14,0.653,9.9,100,18,82,0.18,181,0.552,15,0.602,9.7,2019-20
324,204038,Langston Galloway,1610612765,DET,65,20,45,1682.0,33,4,27,0.121,68,0.485,1,0.493,15.0,115,19,94,0.165,202,0.569,20,0.632,10.7,148,23,121,0.155,266,0.556,21,0.604,11.7,2019-20
325,1626204,Larry Nance Jr.,1610612739,CLE,56,16,40,1472.0,106,83,22,0.783,239,0.444,5,0.453,4.7,303,86,216,0.284,454,0.667,28,0.711,4.9,409,169,238,0.413,657,0.623,33,0.655,4.9,2019-20
326,1628374,Lauri Markkanen,1610612741,CHI,50,18,32,1492.0,60,38,20,0.633,148,0.405,1,0.408,5.2,253,67,187,0.265,386,0.655,21,0.693,5.5,313,105,207,0.335,505,0.62,22,0.648,5.5,2019-20
327,2544,LeBron James,1610612747,LAL,67,50,17,2316.0,66,41,23,0.621,178,0.371,7,0.386,7.5,459,91,368,0.198,642,0.715,31,0.751,6.9,525,132,391,0.251,783,0.67,38,0.705,6.9,2019-20
328,1629022,Lonnie Walker IV,1610612759,SAS,60,28,32,967.0,23,10,14,0.435,57,0.404,3,0.426,10.8,113,12,99,0.106,168,0.673,13,0.729,6.6,136,22,113,0.162,220,0.618,16,0.667,7.3,2019-20
329,1628366,Lonzo Ball,1610612740,NOP,62,26,36,1985.0,68,33,34,0.485,171,0.398,4,0.407,9.3,304,54,245,0.178,454,0.67,34,0.724,7.0,372,87,279,0.234,611,0.609,38,0.649,7.4,2019-20
330,101150,Lou Williams,1610612746,LAC,65,44,21,1864.0,31,16,15,0.516,84,0.369,3,0.383,13.0,170,23,147,0.135,252,0.675,11,0.705,9.4,201,39,162,0.194,330,0.609,14,0.636,10.0,2019-20
331,1629663,Louis King,1610612765,DET,10,3,7,62.0,1,1,0,1.0,4,0.25,0,0.25,5.9,9,3,6,0.333,11,0.818,2,1.0,6.0,10,4,6,0.4,14,0.714,2,0.833,6.0,2019-20
332,201601,Luc Mbah a Moute,1610612745,HOU,3,1,2,25.0,1,1,0,1.0,2,0.5,0,0.5,2.3,1,0,1,0.0,1,1.0,0,1.0,9.7,2,1,1,0.5,2,1.0,0,1.0,6.0,2019-20
333,1629652,Luguentz Dort,1610612760,OKC,36,26,10,820.0,24,14,10,0.583,50,0.48,2,0.5,7.9,57,14,43,0.246,103,0.553,6,0.588,10.6,81,28,53,0.346,148,0.547,8,0.579,9.8,2019-20
334,1629029,Luka Doncic,1610612742,DAL,59,34,25,1973.0,76,43,30,0.566,187,0.406,2,0.411,8.3,468,74,394,0.158,681,0.687,62,0.756,5.5,544,117,424,0.215,848,0.642,64,0.694,5.9,2019-20
335,1629677,Luka Samanic,1610612759,SAS,3,1,2,48.0,1,1,0,1.0,5,0.2,0,0.2,5.8,9,1,8,0.111,14,0.643,3,0.818,7.1,10,2,8,0.2,19,0.526,3,0.625,7.0,2019-20
336,1628379,Luke Kennard,1610612765,DET,27,11,16,888.0,9,6,3,0.667,28,0.321,0,0.321,9.7,89,6,83,0.067,156,0.571,17,0.64,8.3,98,12,86,0.122,183,0.536,17,0.59,8.5,2019-20
337,1628436,Luke Kornet,1610612741,CHI,36,11,25,559.0,22,13,8,0.591,49,0.449,5,0.5,5.0,62,26,35,0.419,119,0.521,13,0.585,5.1,84,39,43,0.464,164,0.512,18,0.575,5.1,2019-20
338,1627763,Malcolm Brogdon,1610612754,IND,54,34,20,1666.0,46,24,23,0.522,111,0.414,4,0.43,12.8,216,44,172,0.204,357,0.605,30,0.661,8.2,262,68,195,0.26,466,0.562,34,0.606,9.1,2019-20
339,1626259,Malcolm Miller,1610612761,TOR,28,24,4,162.0,2,2,0,1.0,6,0.333,0,0.333,2.8,14,4,10,0.286,23,0.609,3,0.7,7.0,16,6,10,0.375,28,0.571,3,0.64,6.5,2019-20
340,1627736,Malik Beasley,1610612750,MIN,55,30,25,1209.0,18,13,5,0.722,59,0.305,3,0.321,10.5,130,18,111,0.138,197,0.66,20,0.734,8.1,148,31,116,0.209,247,0.599,23,0.661,8.4,2019-20
341,1628370,Malik Monk,1610612766,CHA,54,18,36,1136.0,27,11,16,0.407,58,0.466,1,0.474,10.9,125,11,111,0.088,195,0.641,17,0.702,6.7,152,22,127,0.145,250,0.608,18,0.655,7.4,2019-20
342,1629005,Malik Newman,1610612739,CLE,1,0,1,4.0,0,0,0,0.0,0,0.0,0,0.0,0.0,0,0,0,0.0,0,0.0,0,0.0,0.0,0,0,0,0.0,0,0.0,0,0.0,0.0,2019-20
343,201188,Marc Gasol,1610612761,TOR,43,34,9,1145.0,31,12,19,0.387,79,0.392,3,0.408,8.1,242,60,181,0.248,409,0.592,37,0.651,5.5,273,72,200,0.264,470,0.581,40,0.635,5.8,2019-20
344,201158,Marco Belinelli,1610612759,SAS,56,26,30,875.0,7,3,4,0.429,21,0.333,1,0.35,10.1,90,8,80,0.089,132,0.682,13,0.756,7.9,97,11,84,0.113,149,0.651,14,0.719,8.0,2019-20
345,202694,Marcus Morris Sr.,1610612746,LAC,62,26,36,1936.0,59,29,31,0.492,147,0.401,6,0.418,10.2,252,54,198,0.214,407,0.619,36,0.679,6.9,311,83,229,0.267,535,0.581,42,0.631,7.5,2019-20
346,203935,Marcus Smart,1610612738,BOS,60,39,21,1919.0,42,23,19,0.548,110,0.382,7,0.408,10.9,183,50,131,0.273,298,0.614,32,0.688,8.6,225,73,150,0.324,401,0.561,39,0.622,9.0,2019-20
347,1629621,Marial Shayok,1610612755,PHI,4,2,2,28.0,1,1,0,1.0,1,1.0,0,1.0,10.9,6,3,3,0.5,9,0.667,1,0.75,13.4,7,4,3,0.571,10,0.7,1,0.778,13.0,2019-20
348,1626209,Mario Hezonja,1610612757,POR,52,23,29,866.0,30,13,16,0.433,72,0.417,0,0.417,10.4,154,30,117,0.195,239,0.644,19,0.7,5.9,184,43,133,0.234,291,0.632,19,0.676,6.7,2019-20
349,1628365,Markelle Fultz,1610612753,ORL,72,33,39,1996.0,41,24,16,0.585,114,0.36,6,0.38,9.3,197,41,157,0.208,365,0.54,41,0.608,7.3,238,65,173,0.273,477,0.499,47,0.553,7.7,2019-20
350,202693,Markieff Morris,1610612747,LAL,57,22,35,1171.0,40,19,19,0.475,91,0.44,3,0.455,7.5,175,42,133,0.24,286,0.612,27,0.676,6.5,215,61,152,0.284,363,0.592,30,0.646,6.7,2019-20
351,1629741,Marko Guduric,1610612763,MEM,44,19,25,484.0,14,6,6,0.429,29,0.483,0,0.483,13.1,59,14,38,0.237,78,0.756,6,0.819,8.2,73,20,44,0.274,106,0.689,6,0.73,9.1,2019-20
352,1629716,Marques Bolden,1610612739,CLE,1,0,1,3.0,0,0,0,0.0,0,0.0,0,0.0,0.0,2,2,0,1.0,2,1.0,0,1.0,3.1,2,2,0,1.0,2,1.0,0,1.0,3.1,2019-20
353,1627737,Marquese Chriss,1610612744,GSW,59,15,44,1196.0,114,84,30,0.737,260,0.438,4,0.445,5.3,251,87,163,0.347,447,0.562,42,0.62,4.7,365,171,193,0.468,671,0.544,46,0.584,4.9,2019-20
354,1628963,Marvin Bagley III,1610612758,SAC,13,2,11,334.0,29,22,7,0.759,77,0.377,1,0.382,5.5,68,18,49,0.265,102,0.667,9,0.731,4.2,97,40,56,0.412,175,0.554,10,0.588,4.6,2019-20
355,101107,Marvin Williams,1610612749,MIL,57,21,36,1100.0,29,17,13,0.586,69,0.42,4,0.446,8.8,148,33,114,0.223,245,0.604,24,0.67,6.4,177,50,127,0.282,308,0.575,28,0.632,6.8,2019-20
356,203486,Mason Plumlee,1610612743,DEN,61,38,23,1057.0,98,73,25,0.745,232,0.422,9,0.439,4.8,219,66,152,0.301,366,0.598,31,0.654,4.5,317,139,177,0.438,578,0.548,40,0.589,4.6,2019-20
357,1629680,Matisse Thybulle,1610612755,PHI,65,40,25,1287.0,44,17,27,0.386,74,0.595,4,0.629,10.3,63,8,55,0.127,111,0.568,13,0.643,10.6,107,25,82,0.234,183,0.585,17,0.645,10.5,2019-20
358,1629760,Matt Mooney,1610612739,CLE,4,0,4,19.0,0,0,0,0.0,0,0.0,0,0.0,0.0,3,1,2,0.333,4,0.75,0,0.75,4.7,3,1,2,0.333,4,0.75,0,0.75,4.7,2019-20
359,1629744,Matt Thomas,1610612761,TOR,40,30,10,436.0,9,4,5,0.444,24,0.375,1,0.391,15.7,51,9,42,0.176,88,0.58,13,0.68,8.9,60,13,47,0.217,111,0.541,14,0.619,10.0,2019-20
360,203521,Matthew Dellavedova,1610612739,CLE,57,17,40,821.0,18,5,13,0.278,39,0.462,2,0.486,14.6,57,9,45,0.158,104,0.548,16,0.648,9.7,75,14,58,0.187,143,0.524,18,0.6,10.9,2019-20
361,203090,Maurice Harkless,1610612752,NYK,62,39,23,1427.0,55,30,25,0.545,117,0.47,5,0.491,6.4,185,38,145,0.205,264,0.701,19,0.755,7.0,240,68,170,0.283,366,0.656,24,0.702,6.8,2019-20
362,1629622,Max Strus,1610612741,CHI,2,0,2,6.0,1,1,0,1.0,1,1.0,0,1.0,4.8,0,0,0,0.0,0,0.0,0,0.0,0.0,1,1,0,1.0,1,1.0,0,1.0,4.8,2019-20
363,1628467,Maxi Kleber,1610612742,DAL,72,40,32,1832.0,111,77,33,0.694,253,0.439,5,0.448,6.9,269,101,167,0.375,460,0.585,52,0.659,5.6,380,178,200,0.468,671,0.566,57,0.619,6.0,2019-20
364,1628982,Melvin Frazier Jr.,1610612753,ORL,19,6,13,126.0,2,1,0,0.5,3,0.667,1,1.0,2.9,8,2,6,0.25,15,0.533,1,0.571,8.9,10,3,6,0.3,18,0.556,2,0.625,8.2,2019-20
365,203086,Meyers Leonard,1610612748,MIA,51,34,17,1034.0,30,19,11,0.633,101,0.297,2,0.303,10.1,230,51,179,0.222,344,0.669,20,0.71,4.7,260,70,190,0.269,425,0.612,22,0.645,5.3,2019-20
366,1629662,Mfiondu Kabengele,1610612746,LAC,12,9,3,64.0,1,0,1,0.0,7,0.143,1,0.167,8.2,10,2,7,0.2,16,0.625,0,0.625,3.8,11,2,8,0.182,23,0.478,1,0.5,4.3,2019-20
367,203487,Michael Carter-Williams,1610612753,ORL,45,21,24,833.0,46,23,19,0.5,96,0.479,4,0.5,8.1,101,17,84,0.168,169,0.598,15,0.656,7.9,147,40,103,0.272,261,0.563,19,0.607,7.9,2019-20
368,1626187,Michael Frazier,1610612745,HOU,13,7,6,145.0,1,1,0,1.0,2,0.5,0,0.5,4.2,9,0,9,0.0,15,0.6,4,0.818,9.3,10,1,9,0.1,17,0.588,4,0.769,8.7,2019-20
369,203077,Michael Kidd-Gilchrist,1610612742,DAL,24,11,13,279.0,14,10,3,0.714,35,0.4,1,0.412,6.7,53,16,36,0.302,86,0.616,5,0.654,6.1,67,26,39,0.388,119,0.563,6,0.593,6.2,2019-20
370,1629008,Michael Porter Jr.,1610612743,DEN,55,36,19,903.0,66,49,16,0.742,152,0.434,1,0.437,5.7,193,45,148,0.233,284,0.68,24,0.742,4.3,259,94,164,0.363,417,0.621,25,0.661,4.7,2019-20
371,1628969,Mikal Bridges,1610612756,PHX,72,34,38,2010.0,65,31,34,0.477,128,0.508,4,0.524,10.6,217,62,154,0.286,355,0.611,27,0.662,7.4,282,93,188,0.33,471,0.599,31,0.641,8.1,2019-20
372,201144,Mike Conley,1610612762,UTA,47,26,21,1363.0,33,10,20,0.303,85,0.388,6,0.418,14.5,118,17,102,0.144,190,0.621,17,0.682,9.4,151,27,122,0.179,272,0.555,23,0.606,10.4,2019-20
373,203488,Mike Muscala,1610612760,OKC,47,26,21,572.0,16,11,5,0.688,48,0.333,2,0.348,7.2,92,31,60,0.337,174,0.529,25,0.617,5.6,108,42,65,0.389,219,0.493,27,0.563,5.8,2019-20
374,203118,Mike Scott,1610612755,PHI,68,39,29,1207.0,65,41,25,0.631,174,0.374,8,0.392,5.6,183,52,128,0.284,281,0.651,27,0.72,7.0,248,93,153,0.375,438,0.566,35,0.615,6.7,2019-20
375,1628970,Miles Bridges,1610612766,CHA,64,23,41,1976.0,88,42,44,0.477,203,0.433,4,0.442,8.8,272,65,207,0.239,409,0.665,29,0.716,6.1,360,107,251,0.297,581,0.62,33,0.657,6.7,2019-20
376,1629011,Mitchell Robinson,1610612752,NYK,61,20,41,1412.0,186,152,34,0.817,369,0.504,13,0.522,4.6,242,98,143,0.405,439,0.551,48,0.619,5.9,428,250,177,0.584,787,0.544,61,0.59,5.3,2019-20
377,1629671,Miye Oni,1610612762,UTA,10,5,5,109.0,5,2,3,0.4,9,0.556,1,0.625,12.5,12,3,9,0.25,20,0.6,1,0.632,5.3,17,5,12,0.294,29,0.586,2,0.63,7.4,2019-20
378,1628964,Mo Bamba,1610612753,ORL,62,30,32,878.0,100,73,27,0.73,231,0.433,5,0.442,3.8,202,66,132,0.327,365,0.553,34,0.61,3.6,302,139,159,0.46,568,0.532,39,0.571,3.6,2019-20
379,1628420,Monte Morris,1610612743,DEN,73,46,27,1637.0,24,5,19,0.208,72,0.333,6,0.364,16.7,113,17,95,0.15,173,0.653,13,0.706,11.0,137,22,114,0.161,244,0.561,19,0.609,12.0,2019-20
380,1626149,Montrezl Harrell,1610612746,LAC,63,44,19,1749.0,163,124,39,0.761,367,0.444,9,0.455,4.2,282,96,185,0.34,528,0.534,42,0.58,5.8,445,220,224,0.494,870,0.511,51,0.543,5.2,2019-20
381,1629021,Moritz Wagner,1610612764,WAS,45,15,30,835.0,56,45,11,0.804,146,0.384,4,0.394,5.1,163,53,111,0.325,269,0.606,23,0.663,4.5,219,98,122,0.447,395,0.554,27,0.595,4.7,2019-20
382,1629650,Moses Brown,1610612757,POR,9,4,5,33.0,3,3,0,1.0,12,0.25,1,0.273,2.8,11,3,8,0.273,16,0.688,1,0.733,3.7,14,6,8,0.429,25,0.56,2,0.609,3.5,2019-20
383,1628539,Mychal Mulder,1610612744,GSW,7,3,4,204.0,3,1,2,0.333,3,1.0,0,1.0,26.5,20,3,17,0.15,43,0.465,8,0.571,6.8,23,4,19,0.174,46,0.5,8,0.605,9.4,2019-20
384,1626167,Myles Turner,1610612754,IND,62,37,25,1826.0,86,52,34,0.605,185,0.465,5,0.478,6.2,321,103,220,0.321,628,0.511,76,0.582,4.6,407,155,254,0.381,795,0.512,81,0.57,5.0,2019-20
385,1629642,Nassir Little,1610612757,POR,48,22,26,572.0,31,21,10,0.677,82,0.378,0,0.378,6.6,77,22,53,0.286,119,0.647,9,0.7,5.6,108,43,63,0.398,191,0.565,9,0.593,5.9,2019-20
386,1628513,Naz Mitrou-Long,1610612754,IND,5,3,2,47.0,0,0,0,0.0,1,0.0,0,0.0,0.0,7,3,4,0.429,12,0.583,3,0.778,8.7,7,3,4,0.429,13,0.538,3,0.7,8.7,2019-20
387,1629675,Naz Reid,1610612750,MIN,30,8,22,495.0,34,24,10,0.706,95,0.358,2,0.366,4.3,90,31,59,0.344,170,0.529,29,0.638,4.3,124,55,69,0.444,250,0.496,31,0.566,4.3,2019-20
388,202357,Nemanja Bjelica,1610612758,SAC,71,31,40,1981.0,109,79,27,0.725,224,0.487,6,0.5,5.8,339,108,231,0.319,549,0.617,42,0.669,5.0,448,187,258,0.417,742,0.604,48,0.646,5.2,2019-20
389,203457,Nerlens Noel,1610612760,OKC,61,38,23,1127.0,91,61,30,0.67,233,0.391,5,0.399,6.3,209,73,136,0.349,389,0.537,37,0.594,5.2,300,134,166,0.447,602,0.498,42,0.536,5.6,2019-20
390,1629638,Nickeil Alexander-Walker,1610612740,NOP,47,19,28,591.0,9,3,6,0.333,33,0.273,0,0.273,11.1,75,12,63,0.16,139,0.54,21,0.636,5.6,84,15,69,0.179,171,0.491,21,0.56,6.2,2019-20
391,201587,Nicolas Batum,1610612766,CHA,21,6,15,471.0,22,10,11,0.455,39,0.564,2,0.595,10.8,72,20,52,0.278,109,0.661,7,0.706,6.1,94,30,63,0.319,140,0.671,9,0.718,7.1,2019-20
392,1629651,Nicolas Claxton,1610612751,BKN,15,5,10,187.0,19,15,4,0.789,49,0.388,3,0.413,4.8,25,10,12,0.4,45,0.556,5,0.625,3.8,44,25,16,0.568,89,0.494,8,0.543,4.2,2019-20
393,1629740,Nicolo Melli,1610612740,NOP,59,26,33,1016.0,37,23,13,0.622,95,0.389,4,0.407,9.0,139,46,93,0.331,239,0.582,27,0.656,5.3,176,69,106,0.392,324,0.543,31,0.601,6.0,2019-20
394,1628430,Nigel Williams-Goss,1610612762,UTA,10,6,4,50.0,2,1,1,0.5,2,1.0,0,1.0,16.9,4,2,2,0.5,9,0.444,4,0.8,6.5,6,3,3,0.5,10,0.6,4,1.0,9.9,2019-20
395,203999,Nikola Jokic,1610612743,DEN,73,46,27,2335.0,166,126,39,0.759,361,0.46,9,0.472,5.5,545,190,355,0.349,867,0.629,84,0.696,4.3,711,316,394,0.444,1184,0.601,93,0.652,4.6,2019-20
396,202696,Nikola Vucevic,1610612753,ORL,62,28,34,1998.0,140,93,45,0.664,275,0.509,1,0.511,5.0,533,182,346,0.341,768,0.694,67,0.76,4.3,673,275,391,0.409,1018,0.661,68,0.708,4.4,2019-20
397,203943,Noah Vonleh,1610612743,DEN,36,13,23,378.0,37,20,12,0.541,71,0.521,2,0.536,5.5,87,29,56,0.333,151,0.576,19,0.659,3.6,124,49,68,0.395,216,0.574,21,0.636,4.1,2019-20
398,1626181,Norman Powell,1610612761,TOR,51,39,12,1436.0,26,8,17,0.308,66,0.394,2,0.406,11.0,162,36,125,0.222,271,0.598,24,0.656,7.7,188,44,142,0.234,329,0.571,26,0.62,8.2,2019-20
399,203658,Norvel Pelle,1610612755,PHI,24,12,12,232.0,20,18,2,0.9,60,0.333,2,0.345,3.1,52,25,27,0.481,91,0.571,5,0.605,4.3,72,43,29,0.597,147,0.49,7,0.514,4.0,2019-20
400,1628384,OG Anunoby,1610612761,TOR,68,49,19,2027.0,80,45,32,0.563,196,0.408,4,0.417,8.5,282,69,213,0.245,449,0.628,42,0.693,6.0,362,114,245,0.315,615,0.589,46,0.636,6.5,2019-20
401,1629016,Omari Spellman,1610612750,MIN,49,11,38,886.0,77,50,23,0.649,145,0.531,3,0.542,7.1,142,44,93,0.31,233,0.609,21,0.67,5.7,219,94,116,0.429,364,0.602,24,0.644,6.2,2019-20
402,1629052,Oshae Brissett,1610612761,TOR,19,15,4,135.0,9,6,3,0.667,22,0.409,0,0.409,10.1,17,5,12,0.294,24,0.708,1,0.739,6.2,26,11,15,0.423,44,0.591,1,0.605,7.6,2019-20
403,203490,Otto Porter Jr.,1610612741,CHI,14,5,9,331.0,13,8,5,0.615,30,0.433,2,0.464,7.7,35,6,29,0.171,67,0.522,8,0.593,9.4,48,14,34,0.292,94,0.511,10,0.571,8.9,2019-20
404,200782,P.J. Tucker,1610612745,HOU,72,44,28,2467.0,112,49,62,0.438,309,0.362,10,0.375,10.1,364,117,245,0.321,649,0.561,67,0.625,6.0,476,166,307,0.349,915,0.52,77,0.568,7.0,2019-20
405,1629023,P.J. Washington,1610612766,CHA,57,22,35,1739.0,58,31,27,0.534,168,0.345,6,0.358,8.1,258,91,168,0.353,414,0.623,37,0.684,5.5,316,122,195,0.386,555,0.569,43,0.617,6.0,2019-20
406,1628408,PJ Dozier,1610612743,DEN,29,18,11,412.0,10,3,7,0.3,28,0.357,2,0.385,13.3,45,14,31,0.311,72,0.625,8,0.703,7.7,55,17,38,0.309,95,0.579,10,0.647,8.7,2019-20
407,1627783,Pascal Siakam,1610612761,TOR,59,45,14,2072.0,64,39,25,0.609,181,0.354,9,0.372,8.3,367,85,280,0.232,573,0.64,51,0.703,6.0,431,124,305,0.288,722,0.597,60,0.651,6.3,2019-20
408,1626192,Pat Connaughton,1610612749,MIL,66,52,14,1234.0,59,35,23,0.593,122,0.484,6,0.509,7.5,223,51,172,0.229,343,0.65,36,0.726,5.6,282,86,195,0.305,462,0.61,42,0.671,6.0,2019-20
409,201976,Patrick Beverley,1610612746,LAC,51,38,13,1342.0,57,19,37,0.333,105,0.543,3,0.559,11.5,209,24,183,0.115,346,0.604,35,0.672,7.5,266,43,220,0.162,444,0.599,38,0.655,8.4,2019-20
410,1627775,Patrick McCaw,1610612761,TOR,36,26,10,891.0,19,9,10,0.474,42,0.452,2,0.475,12.4,65,16,49,0.246,117,0.556,14,0.631,8.3,84,25,59,0.298,155,0.542,16,0.604,9.2,2019-20
411,202335,Patrick Patterson,1610612746,LAC,59,39,20,776.0,35,12,20,0.343,59,0.593,2,0.614,9.2,116,27,89,0.233,166,0.699,16,0.773,6.2,151,39,109,0.258,220,0.686,18,0.748,6.8,2019-20
412,201988,Patty Mills,1610612759,SAS,65,27,38,1453.0,21,3,18,0.143,40,0.525,1,0.538,22.9,82,8,74,0.098,131,0.626,14,0.701,12.0,103,11,92,0.107,171,0.602,15,0.66,14.2,2019-20
413,202331,Paul George,1610612746,LAC,48,34,14,1419.0,24,11,13,0.458,84,0.286,5,0.304,12.2,248,54,193,0.218,391,0.634,34,0.695,6.2,272,65,206,0.239,466,0.584,39,0.637,6.7,2019-20
414,200794,Paul Millsap,1610612743,DEN,51,30,21,1240.0,98,66,31,0.673,223,0.439,8,0.456,5.7,195,44,151,0.226,323,0.604,23,0.65,5.9,293,110,182,0.375,523,0.56,31,0.596,5.8,2019-20
415,1628778,Paul Watson,1610612761,TOR,10,7,3,87.0,2,1,1,0.5,6,0.333,0,0.333,25.6,15,7,8,0.467,17,0.882,0,0.882,6.9,17,8,9,0.471,20,0.85,0,0.85,9.1,2019-20
416,1626188,Quinn Cook,1610612747,LAL,44,31,13,508.0,11,3,9,0.273,29,0.379,1,0.393,17.2,40,5,30,0.125,53,0.755,7,0.87,11.2,51,8,39,0.157,79,0.646,8,0.718,13.1,2019-20
417,1629683,Quinndary Weatherspoon,1610612759,SAS,11,5,6,78.0,1,1,0,1.0,3,0.333,1,0.5,9.6,6,2,4,0.333,14,0.429,1,0.462,6.9,7,3,4,0.429,17,0.412,2,0.467,7.3,2019-20
418,1629628,RJ Barrett,1610612752,NYK,56,17,39,1704.0,50,23,27,0.46,134,0.373,6,0.391,9.4,229,40,190,0.175,366,0.626,35,0.692,6.2,279,63,217,0.226,477,0.585,41,0.64,6.8,2019-20
419,200765,Rajon Rondo,1610612747,LAL,48,37,11,984.0,23,9,14,0.391,63,0.365,3,0.383,10.1,119,10,109,0.084,176,0.676,9,0.713,9.0,142,19,123,0.134,232,0.612,12,0.645,9.2,2019-20
420,203526,Raul Neto,1610612755,PHI,54,29,25,668.0,11,2,8,0.182,27,0.407,2,0.44,14.6,50,7,40,0.14,90,0.556,11,0.633,9.6,61,9,48,0.148,116,0.526,13,0.592,10.5,2019-20
421,1629730,Rayjon Tucker,1610612762,UTA,20,12,8,161.0,3,0,3,0.0,11,0.273,1,0.3,5.7,17,1,16,0.059,25,0.68,3,0.773,6.7,20,1,19,0.05,34,0.588,4,0.667,6.5,2019-20
422,203493,Reggie Bullock,1610612752,NYK,29,9,20,684.0,13,3,10,0.231,32,0.406,1,0.419,13.5,55,11,44,0.2,91,0.604,13,0.705,8.3,68,14,54,0.206,115,0.591,14,0.673,9.3,2019-20
423,202704,Reggie Jackson,1610612746,LAC,31,16,15,743.0,17,6,11,0.353,42,0.405,0,0.405,10.8,75,9,66,0.12,125,0.6,12,0.664,8.1,92,15,77,0.163,166,0.554,12,0.597,8.6,2019-20
424,1626158,Richaun Holmes,1610612758,SAC,43,16,27,1223.0,127,90,37,0.709,266,0.477,8,0.492,4.8,228,92,136,0.404,417,0.547,46,0.615,4.4,355,182,173,0.513,669,0.531,54,0.577,4.5,2019-20
425,201937,Ricky Rubio,1610612756,PHX,64,32,32,1979.0,46,8,38,0.174,108,0.426,0,0.426,16.7,255,36,218,0.141,407,0.627,37,0.689,7.6,301,44,256,0.146,508,0.593,37,0.639,9.0,2019-20
426,203496,Robert Covington,1610612745,HOU,70,27,43,2137.0,63,30,34,0.476,164,0.384,5,0.396,12.2,400,116,284,0.29,647,0.618,72,0.696,5.2,463,146,318,0.315,772,0.6,77,0.666,6.2,2019-20
427,1629057,Robert Williams III,1610612738,BOS,29,19,10,388.0,40,34,6,0.85,72,0.556,1,0.563,5.8,88,31,57,0.352,140,0.629,11,0.682,6.5,128,65,63,0.508,206,0.621,12,0.66,6.3,2019-20
428,201577,Robin Lopez,1610612749,MIL,66,51,15,958.0,56,42,10,0.75,134,0.418,6,0.438,4.7,105,42,59,0.4,188,0.559,23,0.636,6.1,161,84,69,0.522,313,0.514,29,0.567,5.6,2019-20
429,1629066,Rodions Kurucs,1610612751,BKN,47,18,29,684.0,25,18,6,0.72,65,0.385,2,0.397,7.1,112,20,93,0.179,197,0.569,15,0.615,5.9,137,38,99,0.277,252,0.544,17,0.583,6.1,2019-20
430,203918,Rodney Hood,1610612757,POR,21,8,13,619.0,10,6,3,0.6,20,0.5,0,0.5,6.9,62,12,50,0.194,102,0.608,9,0.667,8.9,72,18,53,0.25,120,0.6,9,0.649,8.6,2019-20
431,203585,Rodney McGruder,1610612746,LAC,56,38,18,871.0,29,13,15,0.448,75,0.387,2,0.397,10.1,122,29,91,0.238,195,0.626,19,0.693,6.8,151,42,106,0.278,268,0.563,21,0.611,7.4,2019-20
432,1629641,Romeo Langford,1610612738,BOS,32,22,10,370.0,15,11,4,0.733,41,0.366,0,0.366,6.6,26,10,16,0.385,45,0.578,6,0.667,8.2,41,21,20,0.512,84,0.488,6,0.526,7.6,2019-20
433,1626178,Rondae Hollis-Jefferson,1610612761,TOR,59,42,17,1116.0,110,73,37,0.664,262,0.42,13,0.442,4.7,172,50,124,0.291,289,0.595,21,0.642,5.8,282,123,161,0.436,536,0.526,34,0.562,5.4,2019-20
434,1626220,Royce O'Neale,1610612762,UTA,71,44,27,2049.0,27,9,17,0.333,79,0.342,4,0.36,12.1,362,80,282,0.221,585,0.619,55,0.683,5.8,389,89,299,0.229,643,0.605,59,0.666,6.3,2019-20
435,200752,Rudy Gay,1610612759,SAS,66,29,37,1429.0,61,36,20,0.59,127,0.48,3,0.492,8.2,291,69,220,0.237,424,0.686,41,0.76,5.2,352,105,240,0.298,522,0.674,44,0.736,5.7,2019-20
436,203497,Rudy Gobert,1610612762,UTA,68,42,26,2333.0,230,157,75,0.683,518,0.444,8,0.451,4.5,686,172,513,0.251,1072,0.64,88,0.697,3.9,916,329,588,0.359,1554,0.589,96,0.628,4.0,2019-20
437,1629060,Rui Hachimura,1610612764,WAS,48,15,33,1444.0,78,43,34,0.551,193,0.404,7,0.419,7.1,216,51,164,0.236,371,0.582,26,0.626,5.2,294,94,198,0.32,538,0.546,33,0.582,5.7,2019-20
438,201566,Russell Westbrook,1610612745,HOU,57,36,21,2049.0,100,57,42,0.57,283,0.353,5,0.36,7.4,351,72,280,0.205,503,0.698,24,0.733,7.6,451,129,322,0.286,749,0.602,29,0.626,7.6,2019-20
439,201583,Ryan Anderson,1610612745,HOU,2,1,1,14.0,0,0,0,0.0,0,0.0,0,0.0,0.0,7,0,1,0.0,2,3.5,0,3.5,3.3,7,0,1,0.0,2,3.5,0,3.5,3.3,2019-20
440,1627853,Ryan Arcidiacono,1610612741,CHI,58,21,37,930.0,20,2,18,0.1,40,0.5,3,0.541,15.6,90,9,78,0.1,140,0.643,14,0.714,8.1,110,11,96,0.1,177,0.621,17,0.688,9.5,2019-20
441,1629151,Ryan Broekhoff,1610612755,PHI,16,9,7,178.0,5,2,3,0.4,13,0.385,1,0.417,3.8,37,11,26,0.297,55,0.673,6,0.755,6.2,42,13,29,0.31,66,0.636,7,0.712,5.9,2019-20
442,1629635,Sekou Doumbouya,1610612765,DET,38,10,28,754.0,20,12,8,0.6,70,0.286,4,0.303,9.7,98,14,84,0.143,174,0.563,18,0.628,5.2,118,26,92,0.22,238,0.496,22,0.546,6.0,2019-20
443,1628400,Semi Ojeleye,1610612738,BOS,69,46,23,1011.0,26,11,15,0.423,76,0.342,4,0.361,13.3,119,34,84,0.286,173,0.688,16,0.758,8.6,145,45,99,0.31,235,0.617,20,0.674,9.5,2019-20
444,201586,Serge Ibaka,1610612761,TOR,54,39,15,1449.0,112,80,32,0.714,248,0.452,7,0.465,5.3,330,107,223,0.324,562,0.587,61,0.659,4.4,442,187,255,0.423,786,0.562,68,0.616,4.6,2019-20
445,203552,Seth Curry,1610612742,DAL,62,36,26,1505.0,24,6,16,0.25,44,0.545,0,0.545,18.1,111,10,101,0.09,187,0.594,17,0.653,9.6,135,16,117,0.119,230,0.587,17,0.634,11.0,2019-20
446,203894,Shabazz Napier,1610612764,WAS,56,16,40,1344.0,26,10,16,0.385,61,0.426,2,0.441,10.2,132,16,115,0.121,211,0.626,21,0.695,8.5,158,26,131,0.165,270,0.585,23,0.64,8.8,2019-20
447,1628983,Shai Gilgeous-Alexander,1610612760,OKC,70,43,27,2428.0,47,19,28,0.404,155,0.303,6,0.315,13.4,365,79,285,0.216,546,0.668,42,0.724,6.6,412,98,313,0.238,662,0.622,48,0.671,7.4,2019-20
448,1629003,Shake Milton,1610612755,PHI,40,23,17,805.0,15,7,8,0.467,32,0.469,2,0.5,9.2,73,13,60,0.178,109,0.67,8,0.723,8.0,88,20,68,0.227,138,0.638,10,0.688,8.2,2019-20
449,1629044,Shamorie Ponds,1610612761,TOR,4,4,0,11.0,0,0,0,0.0,0,0.0,0,0.0,0.0,1,0,1,0.0,1,1.0,0,1.0,7.3,1,0,1,0.0,1,1.0,0,1.0,7.3,2019-20
450,1627885,Shaquille Harrison,1610612741,CHI,43,14,29,484.0,22,7,15,0.318,44,0.5,0,0.5,11.2,64,14,46,0.219,92,0.696,13,0.81,8.5,86,21,61,0.244,132,0.652,13,0.723,9.2,2019-20
451,1628414,Sindarius Thornwell,1610612740,NOP,2,0,2,35.0,0,0,0,0.0,1,0.0,0,0.0,0.0,4,2,2,0.5,6,0.667,1,0.8,7.3,4,2,2,0.5,6,0.667,1,0.8,7.3,2019-20
452,1627746,Skal Labissiere,1610612737,ATL,33,14,19,567.0,65,46,19,0.708,149,0.436,5,0.451,4.7,104,25,78,0.24,213,0.488,31,0.571,4.8,169,71,97,0.42,354,0.477,36,0.531,4.7,2019-20
453,203524,Solomon Hill,1610612748,MIA,59,29,30,1088.0,29,16,13,0.552,75,0.387,2,0.397,11.2,136,31,104,0.228,218,0.624,20,0.687,6.3,165,47,117,0.285,284,0.581,22,0.63,7.1,2019-20
454,203915,Spencer Dinwiddie,1610612751,BKN,64,30,34,1994.0,32,13,20,0.406,89,0.36,3,0.372,12.2,189,34,154,0.18,318,0.594,30,0.656,8.8,221,47,174,0.213,407,0.543,33,0.591,9.3,2019-20
455,1626169,Stanley Johnson,1610612761,TOR,25,19,6,150.0,7,3,4,0.429,18,0.389,2,0.438,11.5,30,6,24,0.2,41,0.732,3,0.789,7.4,37,9,28,0.243,56,0.661,5,0.725,8.2,2019-20
456,1629742,Stanton Kidd,1610612762,UTA,4,3,1,15.0,0,0,0,0.0,1,0.0,0,0.0,0.0,3,0,3,0.0,3,1.0,1,1.5,2.2,3,0,3,0.0,4,0.75,1,1.0,2.2,2019-20
457,201939,Stephen Curry,1610612744,GSW,5,1,4,139.0,4,3,1,0.75,7,0.571,0,0.571,10.7,22,5,17,0.227,34,0.647,2,0.688,8.9,26,8,18,0.308,41,0.634,2,0.667,9.2,2019-20
458,1628425,Sterling Brown,1610612749,MIL,52,39,13,767.0,31,17,14,0.548,82,0.378,1,0.383,8.7,152,20,131,0.132,237,0.641,30,0.734,5.5,183,37,145,0.202,304,0.602,31,0.67,6.1,2019-20
459,203500,Steven Adams,1610612760,OKC,63,40,23,1681.0,207,159,46,0.768,426,0.486,6,0.493,4.7,376,153,219,0.407,621,0.605,62,0.673,4.9,583,312,265,0.535,1026,0.568,68,0.609,4.8,2019-20
460,1629004,Svi Mykhailiuk,1610612765,DET,55,17,38,1253.0,17,3,14,0.176,45,0.378,1,0.386,16.2,86,13,71,0.151,138,0.623,9,0.667,10.5,103,16,85,0.155,180,0.572,10,0.606,11.5,2019-20
461,1628388,T.J. Leaf,1610612754,IND,28,16,12,222.0,23,13,8,0.565,39,0.59,2,0.622,5.3,48,13,32,0.271,72,0.667,5,0.716,4.9,71,26,40,0.366,107,0.664,7,0.71,5.0,2019-20
462,204456,T.J. McConnell,1610612754,IND,71,44,27,1326.0,38,11,25,0.289,80,0.475,2,0.487,12.2,151,14,140,0.093,241,0.627,18,0.677,9.0,189,25,165,0.132,317,0.596,20,0.636,9.6,2019-20
463,203933,T.J. Warren,1610612754,IND,67,42,25,2202.0,68,47,20,0.691,162,0.42,2,0.425,6.6,212,49,162,0.231,332,0.639,19,0.677,8.2,280,96,182,0.343,480,0.583,21,0.61,7.8,2019-20
464,1629605,Tacko Fall,1610612738,BOS,7,5,2,33.0,1,1,0,1.0,6,0.167,0,0.167,2.8,14,5,9,0.357,17,0.824,1,0.875,4.3,15,6,9,0.4,22,0.682,1,0.714,4.2,2019-20
465,201959,Taj Gibson,1610612752,NYK,62,21,41,1025.0,111,80,30,0.721,223,0.498,6,0.512,5.7,156,50,105,0.321,281,0.555,31,0.624,6.1,267,130,135,0.487,485,0.551,37,0.596,5.9,2019-20
466,1629659,Talen Horton-Tucker,1610612747,LAL,6,2,4,81.0,2,1,1,0.5,4,0.5,1,0.667,15.5,5,1,4,0.2,11,0.455,1,0.5,5.2,7,2,5,0.286,14,0.5,2,0.583,8.1,2019-20
467,1629745,Tariq Owens,1610612756,PHX,3,0,3,15.0,2,0,2,0.0,2,1.0,0,1.0,6.5,1,0,1,0.0,2,0.5,0,0.5,5.9,3,0,3,0.0,4,0.75,0,0.75,6.3,2019-20
468,1627752,Taurean Prince,1610612751,BKN,64,30,34,1857.0,50,21,28,0.42,123,0.407,2,0.413,12.3,331,78,252,0.236,527,0.628,39,0.678,5.6,381,99,280,0.26,611,0.624,41,0.668,6.5,2019-20
469,1629611,Terance Mann,1610612746,LAC,41,27,14,362.0,10,6,4,0.6,28,0.357,3,0.4,7.3,45,5,39,0.111,76,0.592,5,0.634,6.3,55,11,43,0.2,99,0.556,8,0.604,6.5,2019-20
470,1629056,Terence Davis,1610612761,TOR,71,52,19,1203.0,50,20,29,0.4,105,0.476,3,0.49,10.2,184,32,150,0.174,272,0.676,20,0.73,7.5,234,52,179,0.222,371,0.631,23,0.672,8.1,2019-20
471,1628390,Terrance Ferguson,1610612760,OKC,56,33,23,1257.0,23,6,17,0.261,44,0.523,5,0.59,10.6,51,10,38,0.196,101,0.505,15,0.593,8.0,74,16,55,0.216,144,0.514,20,0.597,8.9,2019-20
472,203082,Terrence Ross,1610612753,ORL,69,31,38,1889.0,13,4,8,0.308,48,0.271,4,0.295,14.6,209,32,175,0.153,318,0.657,23,0.708,7.6,222,36,183,0.162,358,0.62,27,0.671,8.0,2019-20
473,1626179,Terry Rozier,1610612766,CHA,62,21,41,2127.0,49,18,31,0.367,124,0.395,8,0.422,12.8,221,35,185,0.158,338,0.654,22,0.699,8.3,270,53,216,0.196,459,0.588,30,0.629,9.1,2019-20
474,200757,Thabo Sefolosha,1610612745,HOU,41,27,14,436.0,21,7,10,0.333,51,0.412,5,0.457,11.0,72,13,51,0.181,96,0.75,8,0.818,5.5,93,20,61,0.215,140,0.664,13,0.732,6.7,2019-20
475,201152,Thaddeus Young,1610612741,CHI,64,22,42,1591.0,94,56,38,0.596,219,0.429,2,0.433,7.6,221,57,163,0.258,336,0.658,22,0.704,6.3,315,113,201,0.359,521,0.605,24,0.634,6.7,2019-20
476,203648,Thanasis Antetokounmpo,1610612749,MIL,19,15,4,128.0,12,9,3,0.75,21,0.571,0,0.571,6.0,12,1,11,0.083,18,0.667,2,0.75,9.5,24,10,14,0.417,39,0.615,2,0.649,7.7,2019-20
477,1629033,Theo Pinson,1610612752,NYK,33,15,18,365.0,10,3,7,0.3,24,0.417,1,0.435,15.3,44,11,30,0.25,84,0.524,9,0.587,6.1,54,14,37,0.259,107,0.505,10,0.557,7.9,2019-20
478,1628418,Thomas Bryant,1610612764,WAS,46,15,31,1147.0,98,63,33,0.643,181,0.541,6,0.56,6.7,233,71,162,0.305,371,0.628,28,0.679,5.2,331,134,195,0.405,540,0.613,34,0.654,5.6,2019-20
479,1627748,Thon Maker,1610612765,DET,59,20,39,774.0,54,32,22,0.593,129,0.419,5,0.435,6.5,113,24,89,0.212,209,0.541,28,0.624,6.0,167,56,111,0.335,324,0.515,33,0.574,6.2,2019-20
480,204025,Tim Frazier,1610612765,DET,26,9,17,353.0,9,4,5,0.444,19,0.474,0,0.474,9.3,24,1,23,0.042,50,0.48,5,0.533,8.9,33,5,28,0.152,69,0.478,5,0.516,9.0,2019-20
481,203501,Tim Hardaway Jr.,1610612742,DAL,69,39,30,2027.0,25,11,15,0.44,75,0.333,1,0.338,16.3,201,31,168,0.154,320,0.628,22,0.674,7.3,226,42,183,0.186,389,0.581,23,0.617,8.4,2019-20
482,1627789,Timothe Luwawu-Cabarrot,1610612751,BKN,47,20,27,853.0,29,12,17,0.414,64,0.453,2,0.468,10.4,98,24,74,0.245,170,0.576,23,0.667,7.8,127,36,91,0.283,229,0.555,25,0.623,8.4,2019-20
483,202699,Tobias Harris,1610612755,PHI,72,43,29,2469.0,69,50,17,0.725,239,0.289,11,0.303,6.1,426,97,330,0.228,666,0.64,65,0.709,5.3,495,147,347,0.297,871,0.568,76,0.623,5.4,2019-20
484,203107,Tomas Satoransky,1610612741,CHI,65,22,43,1878.0,76,33,43,0.434,177,0.429,3,0.437,9.9,178,31,147,0.174,275,0.647,21,0.701,8.2,254,64,190,0.252,439,0.579,24,0.612,8.7,2019-20
485,1628396,Tony Bradley,1610612762,UTA,58,36,22,663.0,111,73,36,0.658,219,0.507,2,0.512,4.2,156,51,104,0.327,231,0.675,21,0.743,4.3,267,124,140,0.464,426,0.627,23,0.663,4.3,2019-20
486,203503,Tony Snell,1610612765,DET,58,18,40,1613.0,9,4,4,0.444,31,0.29,4,0.333,17.9,101,24,77,0.238,188,0.537,25,0.62,8.4,110,28,81,0.255,214,0.514,29,0.595,9.1,2019-20
487,1628470,Torrey Craig,1610612743,DEN,58,38,20,1072.0,63,41,19,0.651,142,0.444,9,0.474,7.2,126,20,101,0.159,198,0.636,23,0.72,6.1,189,61,120,0.323,326,0.58,32,0.643,6.5,2019-20
488,1629027,Trae Young,1610612737,ATL,60,18,42,2120.0,32,12,19,0.375,131,0.244,6,0.256,11.8,223,30,193,0.135,360,0.619,32,0.68,9.2,255,42,212,0.165,484,0.527,38,0.572,9.5,2019-20
489,1629682,Tremont Waters,1610612738,BOS,11,8,3,119.0,0,0,0,0.0,3,0.0,0,0.0,0.0,12,3,9,0.25,17,0.706,0,0.706,11.7,12,3,9,0.25,20,0.6,0,0.6,11.7,2019-20
490,1626203,Treveon Graham,1610612737,ATL,55,21,34,929.0,51,30,20,0.588,120,0.425,2,0.432,6.1,99,29,69,0.293,189,0.524,26,0.607,6.2,150,59,89,0.393,302,0.497,28,0.547,6.2,2019-20
491,2772,Trevor Ariza,1610612757,POR,52,21,31,1453.0,34,14,18,0.412,86,0.395,3,0.41,9.9,208,40,168,0.192,301,0.691,26,0.756,7.0,242,54,186,0.223,366,0.661,29,0.718,7.4,2019-20
492,203504,Trey Burke,1610612742,DAL,33,16,17,520.0,16,1,13,0.063,32,0.5,1,0.516,17.5,34,3,31,0.088,49,0.694,6,0.791,9.6,50,4,44,0.08,80,0.625,7,0.685,11.9,2019-20
493,1626168,Trey Lyles,1610612759,SAS,62,26,36,1254.0,71,46,25,0.648,154,0.461,6,0.48,6.7,283,55,228,0.194,434,0.652,38,0.715,4.7,354,101,253,0.285,569,0.622,44,0.674,5.1,2019-20
494,202684,Tristan Thompson,1610612739,CLE,57,19,38,1722.0,226,162,64,0.717,511,0.442,15,0.456,5.4,351,96,256,0.274,537,0.654,41,0.708,5.6,577,258,320,0.447,1030,0.56,56,0.592,5.5,2019-20
495,1628972,Troy Brown Jr.,1610612764,WAS,69,24,45,1782.0,76,38,37,0.5,187,0.406,5,0.418,8.9,307,78,228,0.254,492,0.624,50,0.695,6.0,383,116,265,0.303,650,0.589,55,0.644,6.6,2019-20
496,203584,Troy Daniels,1610612743,DEN,47,34,13,532.0,12,5,7,0.417,18,0.667,1,0.706,7.7,40,4,28,0.1,52,0.769,7,0.889,7.4,52,9,35,0.173,69,0.754,8,0.852,7.4,2019-20
497,1629660,Ty Jerome,1610612756,PHX,31,16,15,328.0,7,1,5,0.143,22,0.318,1,0.333,12.6,39,15,24,0.385,54,0.722,3,0.765,8.1,46,16,29,0.348,72,0.639,4,0.676,8.7,2019-20
498,1629076,Tyler Cook,1610612743,DEN,13,3,10,54.0,6,4,0,0.667,9,0.667,0,0.667,3.8,8,1,6,0.125,11,0.727,2,0.889,4.1,14,5,6,0.357,18,0.778,2,0.875,4.0,2019-20
499,1629639,Tyler Herro,1610612748,MIA,55,34,21,1508.0,16,6,10,0.375,61,0.262,2,0.271,12.8,208,31,174,0.149,342,0.608,44,0.698,6.1,224,37,184,0.165,388,0.577,46,0.655,6.6,2019-20
500,204020,Tyler Johnson,1610612751,BKN,38,16,22,694.0,18,3,15,0.167,43,0.419,0,0.419,11.0,57,11,47,0.193,104,0.548,14,0.633,8.5,75,14,62,0.187,145,0.517,14,0.573,9.1,2019-20
501,203092,Tyler Zeller,1610612759,SAS,2,1,1,4.0,3,2,1,0.667,4,0.75,1,1.0,2.3,1,0,1,0.0,1,1.0,0,1.0,1.6,4,2,2,0.5,5,0.8,1,1.0,2.1,2019-20
502,1627820,Tyrone Wallace,1610612737,ATL,14,3,11,160.0,3,1,2,0.333,8,0.375,0,0.375,10.5,19,7,11,0.368,26,0.731,1,0.76,9.5,22,8,13,0.364,32,0.688,1,0.71,9.6,2019-20
503,2199,Tyson Chandler,1610612745,HOU,26,15,11,219.0,25,16,9,0.64,46,0.543,1,0.556,6.9,41,14,25,0.341,72,0.569,10,0.661,4.9,66,30,34,0.455,117,0.564,11,0.623,5.7,2019-20
504,1626145,Tyus Jones,1610612763,MEM,65,32,33,1232.0,9,2,7,0.222,31,0.29,2,0.31,12.5,94,7,81,0.074,132,0.712,10,0.77,9.1,103,9,88,0.087,162,0.636,12,0.687,9.4,2019-20
505,2617,Udonis Haslem,1610612748,MIA,4,3,1,44.0,1,1,0,1.0,11,0.091,0,0.091,7.6,15,4,11,0.267,20,0.75,1,0.789,3.3,16,5,11,0.313,29,0.552,1,0.571,3.6,2019-20
506,1629724,Vic Law,1610612753,ORL,8,2,6,62.0,2,1,1,0.5,10,0.2,0,0.2,2.7,9,0,9,0.0,17,0.529,1,0.563,4.4,11,1,10,0.091,26,0.423,1,0.44,4.1,2019-20
507,203506,Victor Oladipo,1610612754,IND,19,11,8,528.0,9,1,8,0.111,20,0.45,1,0.474,16.0,66,22,44,0.333,122,0.541,14,0.611,7.0,75,23,52,0.307,142,0.528,15,0.591,8.0,2019-20
508,1713,Vince Carter,1610612737,ATL,60,19,41,876.0,18,8,10,0.444,68,0.265,4,0.281,14.1,106,30,70,0.283,184,0.576,25,0.667,6.1,124,38,80,0.306,232,0.534,29,0.611,7.3,2019-20
509,1629738,Vincent Poirier,1610612738,BOS,22,18,4,130.0,13,8,3,0.615,33,0.394,0,0.394,4.4,30,12,18,0.4,48,0.625,5,0.698,4.7,43,20,21,0.465,74,0.581,5,0.623,4.6,2019-20
510,1628427,Vlatko Cancar,1610612743,DEN,14,7,7,45.0,5,5,0,1.0,9,0.556,0,0.556,3.3,5,4,1,0.8,8,0.625,1,0.714,7.6,10,9,1,0.9,16,0.625,1,0.667,5.5,2019-20
511,201961,Wayne Ellington,1610612752,NYK,36,9,27,558.0,4,2,2,0.5,10,0.4,0,0.4,10.8,61,8,51,0.131,86,0.709,3,0.735,10.1,65,10,53,0.154,94,0.691,3,0.714,10.1,2019-20
512,1628976,Wendell Carter Jr.,1610612741,CHI,43,15,28,1256.0,139,110,28,0.791,318,0.437,7,0.447,4.7,266,107,158,0.402,460,0.578,47,0.644,4.4,405,217,186,0.536,758,0.534,54,0.575,4.5,2019-20
513,1629117,Wenyen Gabriel,1610612757,POR,29,9,20,228.0,21,15,6,0.714,46,0.457,0,0.457,6.0,29,7,22,0.241,57,0.509,6,0.569,6.4,50,22,28,0.44,97,0.515,6,0.549,6.2,2019-20
514,1628411,Wes Iwundu,1610612753,ORL,52,23,29,953.0,24,16,9,0.667,66,0.364,2,0.375,7.1,107,24,84,0.224,196,0.546,16,0.594,5.5,131,40,93,0.305,259,0.506,18,0.544,5.8,2019-20
515,202083,Wesley Matthews,1610612749,MIL,66,51,15,1617.0,22,8,14,0.364,65,0.338,0,0.338,11.8,143,25,118,0.175,226,0.633,21,0.698,8.7,165,33,132,0.2,287,0.575,21,0.62,9.1,2019-20
516,203115,Will Barton,1610612743,DEN,58,38,20,1916.0,76,49,27,0.645,162,0.469,2,0.475,7.2,289,49,241,0.17,466,0.62,37,0.674,5.7,365,98,268,0.268,606,0.602,39,0.644,6.0,2019-20
517,1629739,William Howard,1610612745,HOU,2,1,1,13.0,0,0,0,0.0,1,0.0,0,0.0,0.0,2,0,2,0.0,2,1.0,0,1.0,3.9,2,0,2,0.0,2,1.0,0,1.0,3.9,2019-20
518,1626161,Willie Cauley-Stein,1610612742,DAL,53,15,38,1082.0,84,53,31,0.631,187,0.449,7,0.467,7.5,226,81,145,0.358,388,0.582,35,0.64,4.9,310,134,176,0.432,556,0.558,42,0.603,5.6,2019-20
519,1626195,Willy Hernangomez,1610612766,CHA,30,7,23,367.0,42,35,9,0.833,80,0.525,0,0.525,6.0,91,27,64,0.297,134,0.679,5,0.705,4.1,133,62,73,0.466,205,0.649,5,0.665,4.7,2019-20
520,201163,Wilson Chandler,1610612751,BKN,35,16,19,734.0,11,10,2,0.909,52,0.212,3,0.224,5.4,134,36,98,0.269,209,0.641,22,0.717,4.9,145,46,100,0.317,249,0.582,25,0.647,4.9,2019-20
521,1627812,Yogi Ferrell,1610612758,SAC,50,20,30,530.0,6,3,3,0.5,17,0.353,1,0.375,9.9,43,3,39,0.07,64,0.672,7,0.754,9.1,49,6,42,0.122,80,0.613,8,0.681,9.2,2019-20
522,1629139,Yuta Watanabe,1610612763,MEM,18,9,9,105.0,7,3,4,0.429,15,0.467,3,0.583,10.5,13,7,6,0.538,24,0.542,1,0.565,6.8,20,10,10,0.5,39,0.513,4,0.571,8.1,2019-20
523,1628380,Zach Collins,1610612757,POR,11,8,3,290.0,25,17,8,0.68,55,0.455,1,0.463,4.6,44,16,28,0.364,76,0.579,6,0.629,5.0,69,33,36,0.478,125,0.552,7,0.585,4.9,2019-20
524,203897,Zach LaVine,1610612741,CHI,60,20,40,2085.0,41,14,28,0.341,162,0.253,5,0.261,12.0,248,30,218,0.121,368,0.674,27,0.727,6.8,289,44,246,0.152,496,0.583,32,0.623,7.5,2019-20
525,1629668,Zach Norvell Jr.,1610612744,GSW,5,2,3,41.0,0,0,0,0.0,2,0.0,0,0.0,0.0,6,2,3,0.333,8,0.75,1,0.857,12.8,6,2,3,0.333,8,0.75,1,0.857,12.8,2019-20
526,1629015,Zhaire Smith,1610612755,PHI,7,3,4,32.0,0,0,0,0.0,1,0.0,1,0.0,0.0,2,0,2,0.0,3,0.667,1,1.0,16.3,2,0,2,0.0,4,0.5,2,1.0,16.3,2019-20
527,1629627,Zion Williamson,1610612740,NOP,23,11,12,633.0,62,43,18,0.694,138,0.449,2,0.456,5.2,82,26,57,0.317,125,0.656,9,0.707,7.5,144,69,75,0.479,246,0.585,11,0.613,6.6,2019-20
528,1629597,Zylan Cheatham,1610612740,NOP,4,2,2,51.0,3,2,1,0.667,9,0.333,0,0.333,6.0,6,1,5,0.167,11,0.545,2,0.667,6.5,9,3,6,0.333,20,0.45,2,0.5,6.3,2019-20
